bogsigavedikakšen	bogsigavedikakšen-Pi-msn,-*-,bogsigavedikakšen-Pi-msa
bogsigavedikakšna	bogsigavedikakšen-Pi-mdn,-*-,bogsigavedikakšen-Pi-mda,-*-,bogsigavedikakšen-Pi-npn,-*-,bogsigavedikakšen-Pi-npa,-*-,bogsigavedikakšen-Pi-fsn
bogsigavedikakšne	bogsigavedikakšen-Pi-mpa,-*-,bogsigavedikakšen-Pi-fsg,-*-,bogsigavedikakšen-Pi-fpn,-*-,bogsigavedikakšen-Pi-fpa
bogsigavedikakšnega	bogsigavedikakšen-Pi-msg,-*-,bogsigavedikakšen-Pi-msa,-*-,bogsigavedikakšen-Pi-nsg
bogsigavedikakšnem	bogsigavedikakšen-Pi-msl,-*-,bogsigavedikakšen-Pi-nsl
bogsigavedikakšnemu	bogsigavedikakšen-Pi-msd,-*-,bogsigavedikakšen-Pi-nsd
bogsigavedikakšni	bogsigavedikakšen-Pi-mpn,-*-,bogsigavedikakšen-Pi-ndn,-*-,bogsigavedikakšen-Pi-nda,-*-,bogsigavedikakšen-Pi-fdn,-*-,bogsigavedikakšen-Pi-fda,-*-,bogsigavedikakšen-Pi-fsd,-*-,bogsigavedikakšen-Pi-fsl
bogsigavedikakšnih	bogsigavedikakšen-Pi-mdl,-*-,bogsigavedikakšen-Pi-mdg,-*-,bogsigavedikakšen-Pi-mpl,-*-,bogsigavedikakšen-Pi-mpg,-*-,bogsigavedikakšen-Pi-ndl,-*-,bogsigavedikakšen-Pi-ndg,-*-,bogsigavedikakšen-Pi-npl,-*-,bogsigavedikakšen-Pi-npg,-*-,bogsigavedikakšen-Pi-fdl,-*-,bogsigavedikakšen-Pi-fdg,-*-,bogsigavedikakšen-Pi-fpl,-*-,bogsigavedikakšen-Pi-fpg
bogsigavedikakšnim	bogsigavedikakšen-Pi-msi,-*-,bogsigavedikakšen-Pi-mpd,-*-,bogsigavedikakšen-Pi-nsi,-*-,bogsigavedikakšen-Pi-npd,-*-,bogsigavedikakšen-Pi-fpd
bogsigavedikakšnima	bogsigavedikakšen-Pi-mdd,-*-,bogsigavedikakšen-Pi-mdi,-*-,bogsigavedikakšen-Pi-ndd,-*-,bogsigavedikakšen-Pi-ndi,-*-,bogsigavedikakšen-Pi-fdd,-*-,bogsigavedikakšen-Pi-fdi
bogsigavedikakšnimi	bogsigavedikakšen-Pi-mpi,-*-,bogsigavedikakšen-Pi-npi,-*-,bogsigavedikakšen-Pi-fpi
bogsigavedikakšno	bogsigavedikakšen-Pi-nsn,-*-,bogsigavedikakšen-Pi-nsa,-*-,bogsigavedikakšen-Pi-fsi,-*-,bogsigavedikakšen-Pi-fsa
bogvedikaj	bogvedikaj-Pi-nsn,-*-,bogvedikaj-Pi-nsa
bogvedikatera	bogvedikateri-Pi-mdn,-*-,bogvedikateri-Pi-mda,-*-,bogvedikateri-Pi-npn,-*-,bogvedikateri-Pi-npa,-*-,bogvedikateri-Pi-fsn
bogvedikatere	bogvedikateri-Pi-mpa,-*-,bogvedikateri-Pi-fsg,-*-,bogvedikateri-Pi-fpn,-*-,bogvedikateri-Pi-fpa
bogvedikaterega	bogvedikateri-Pi-msg,-*-,bogvedikateri-Pi-msa,-*-,bogvedikateri-Pi-nsg
bogvedikaterem	bogvedikateri-Pi-msl,-*-,bogvedikateri-Pi-nsl
bogvedikateremu	bogvedikateri-Pi-msd,-*-,bogvedikateri-Pi-nsd
bogvedikateri	bogvedikateri-Pi-msn,-*-,bogvedikateri-Pi-msa,-*-,bogvedikateri-Pi-mpn,-*-,bogvedikateri-Pi-ndn,-*-,bogvedikateri-Pi-nda,-*-,bogvedikateri-Pi-fdn,-*-,bogvedikateri-Pi-fda,-*-,bogvedikateri-Pi-fsd,-*-,bogvedikateri-Pi-fsl
bogvedikaterih	bogvedikateri-Pi-mdl,-*-,bogvedikateri-Pi-mdg,-*-,bogvedikateri-Pi-mpl,-*-,bogvedikateri-Pi-mpg,-*-,bogvedikateri-Pi-ndl,-*-,bogvedikateri-Pi-ndg,-*-,bogvedikateri-Pi-npl,-*-,bogvedikateri-Pi-npg,-*-,bogvedikateri-Pi-fdl,-*-,bogvedikateri-Pi-fdg,-*-,bogvedikateri-Pi-fpl,-*-,bogvedikateri-Pi-fpg
bogvedikaterim	bogvedikateri-Pi-msi,-*-,bogvedikateri-Pi-mpd,-*-,bogvedikateri-Pi-nsi,-*-,bogvedikateri-Pi-npd,-*-,bogvedikateri-Pi-fpd
bogvedikaterima	bogvedikateri-Pi-mdd,-*-,bogvedikateri-Pi-mdi,-*-,bogvedikateri-Pi-ndd,-*-,bogvedikateri-Pi-ndi,-*-,bogvedikateri-Pi-fdd,-*-,bogvedikateri-Pi-fdi
bogvedikaterimi	bogvedikateri-Pi-mpi,-*-,bogvedikateri-Pi-npi,-*-,bogvedikateri-Pi-fpi
bogvedikatero	bogvedikateri-Pi-nsn,-*-,bogvedikateri-Pi-nsa,-*-,bogvedikateri-Pi-fsi,-*-,bogvedikateri-Pi-fsa
bogvedičem	bogvedikaj-Pi-nsl
bogvedičemu	bogvedikaj-Pi-nsd
bogvedičesa	bogvedikaj-Pi-nsg
bogvedičim	bogvedikaj-Pi-nsi
bogvekaj	bogvekaj-Pi-nsn,-*-,bogvekaj-Pi-nsa
bogvekakšen	bogvekakšen-Pi-msn,-*-,bogvekakšen-Pi-msa
bogvekakšna	bogvekakšen-Pi-mdn,-*-,bogvekakšen-Pi-mda,-*-,bogvekakšen-Pi-npn,-*-,bogvekakšen-Pi-npa,-*-,bogvekakšen-Pi-fsn
bogvekakšne	bogvekakšen-Pi-mpa,-*-,bogvekakšen-Pi-fsg,-*-,bogvekakšen-Pi-fpn,-*-,bogvekakšen-Pi-fpa
bogvekakšnega	bogvekakšen-Pi-msg,-*-,bogvekakšen-Pi-msa,-*-,bogvekakšen-Pi-nsg
bogvekakšnem	bogvekakšen-Pi-msl,-*-,bogvekakšen-Pi-nsl
bogvekakšnemu	bogvekakšen-Pi-msd,-*-,bogvekakšen-Pi-nsd
bogvekakšni	bogvekakšen-Pi-mpn,-*-,bogvekakšen-Pi-ndn,-*-,bogvekakšen-Pi-nda,-*-,bogvekakšen-Pi-fdn,-*-,bogvekakšen-Pi-fda,-*-,bogvekakšen-Pi-fsd,-*-,bogvekakšen-Pi-fsl
bogvekakšnih	bogvekakšen-Pi-mdl,-*-,bogvekakšen-Pi-mdg,-*-,bogvekakšen-Pi-mpl,-*-,bogvekakšen-Pi-mpg,-*-,bogvekakšen-Pi-ndl,-*-,bogvekakšen-Pi-ndg,-*-,bogvekakšen-Pi-npl,-*-,bogvekakšen-Pi-npg,-*-,bogvekakšen-Pi-fdl,-*-,bogvekakšen-Pi-fdg,-*-,bogvekakšen-Pi-fpl,-*-,bogvekakšen-Pi-fpg
bogvekakšnim	bogvekakšen-Pi-msi,-*-,bogvekakšen-Pi-mpd,-*-,bogvekakšen-Pi-nsi,-*-,bogvekakšen-Pi-npd,-*-,bogvekakšen-Pi-fpd
bogvekakšnima	bogvekakšen-Pi-mdd,-*-,bogvekakšen-Pi-mdi,-*-,bogvekakšen-Pi-ndd,-*-,bogvekakšen-Pi-ndi,-*-,bogvekakšen-Pi-fdd,-*-,bogvekakšen-Pi-fdi
bogvekakšnimi	bogvekakšen-Pi-mpi,-*-,bogvekakšen-Pi-npi,-*-,bogvekakšen-Pi-fpi
bogvekakšno	bogvekakšen-Pi-nsn,-*-,bogvekakšen-Pi-nsa,-*-,bogvekakšen-Pi-fsi,-*-,bogvekakšen-Pi-fsa
bogvekatera	bogvekateri-Pi-mdn,-*-,bogvekateri-Pi-mda,-*-,bogvekateri-Pi-npn,-*-,bogvekateri-Pi-npa,-*-,bogvekateri-Pi-fsn
bogvekatere	bogvekateri-Pi-mpa,-*-,bogvekateri-Pi-fsg,-*-,bogvekateri-Pi-fpn,-*-,bogvekateri-Pi-fpa
bogvekaterega	bogvekateri-Pi-msg,-*-,bogvekateri-Pi-msa,-*-,bogvekateri-Pi-nsg
bogvekaterem	bogvekateri-Pi-msl,-*-,bogvekateri-Pi-nsl
bogvekateremu	bogvekateri-Pi-msd,-*-,bogvekateri-Pi-nsd
bogvekateri	bogvekateri-Pi-msn,-*-,bogvekateri-Pi-msa,-*-,bogvekateri-Pi-mpn,-*-,bogvekateri-Pi-ndn,-*-,bogvekateri-Pi-nda,-*-,bogvekateri-Pi-fdn,-*-,bogvekateri-Pi-fda,-*-,bogvekateri-Pi-fsd,-*-,bogvekateri-Pi-fsl
bogvekaterih	bogvekateri-Pi-mdl,-*-,bogvekateri-Pi-mdg,-*-,bogvekateri-Pi-mpl,-*-,bogvekateri-Pi-mpg,-*-,bogvekateri-Pi-ndl,-*-,bogvekateri-Pi-ndg,-*-,bogvekateri-Pi-npl,-*-,bogvekateri-Pi-npg,-*-,bogvekateri-Pi-fdl,-*-,bogvekateri-Pi-fdg,-*-,bogvekateri-Pi-fpl,-*-,bogvekateri-Pi-fpg
bogvekaterim	bogvekateri-Pi-msi,-*-,bogvekateri-Pi-mpd,-*-,bogvekateri-Pi-nsi,-*-,bogvekateri-Pi-npd,-*-,bogvekateri-Pi-fpd
bogvekaterima	bogvekateri-Pi-mdd,-*-,bogvekateri-Pi-mdi,-*-,bogvekateri-Pi-ndd,-*-,bogvekateri-Pi-ndi,-*-,bogvekateri-Pi-fdd,-*-,bogvekateri-Pi-fdi
bogvekaterimi	bogvekateri-Pi-mpi,-*-,bogvekateri-Pi-npi,-*-,bogvekateri-Pi-fpi
bogvekatero	bogvekateri-Pi-nsn,-*-,bogvekateri-Pi-nsa,-*-,bogvekateri-Pi-fsi,-*-,bogvekateri-Pi-fsa
bogvekolik	bogvekolik-Pi-msn,-*-,bogvekolik-Pi-msa
bogvekolika	bogvekolik-Pi-mdn,-*-,bogvekolik-Pi-mda,-*-,bogvekolik-Pi-npn,-*-,bogvekolik-Pi-npa,-*-,bogvekolik-Pi-fsn
bogvekolike	bogvekolik-Pi-mpa,-*-,bogvekolik-Pi-fsg,-*-,bogvekolik-Pi-fpn,-*-,bogvekolik-Pi-fpa
bogvekolikega	bogvekolik-Pi-msg,-*-,bogvekolik-Pi-msa,-*-,bogvekolik-Pi-nsg
bogvekolikem	bogvekolik-Pi-msl,-*-,bogvekolik-Pi-nsl
bogvekolikemu	bogvekolik-Pi-msd,-*-,bogvekolik-Pi-nsd
bogvekoliki	bogvekolik-Pi-mpn,-*-,bogvekolik-Pi-ndn,-*-,bogvekolik-Pi-nda,-*-,bogvekolik-Pi-fdn,-*-,bogvekolik-Pi-fda,-*-,bogvekolik-Pi-fsd,-*-,bogvekolik-Pi-fsl
bogvekolikih	bogvekolik-Pi-mdl,-*-,bogvekolik-Pi-mdg,-*-,bogvekolik-Pi-mpl,-*-,bogvekolik-Pi-mpg,-*-,bogvekolik-Pi-ndl,-*-,bogvekolik-Pi-ndg,-*-,bogvekolik-Pi-npl,-*-,bogvekolik-Pi-npg,-*-,bogvekolik-Pi-fdl,-*-,bogvekolik-Pi-fdg,-*-,bogvekolik-Pi-fpl,-*-,bogvekolik-Pi-fpg
bogvekolikim	bogvekolik-Pi-msi,-*-,bogvekolik-Pi-mpd,-*-,bogvekolik-Pi-nsi,-*-,bogvekolik-Pi-npd,-*-,bogvekolik-Pi-fpd
bogvekolikima	bogvekolik-Pi-mdd,-*-,bogvekolik-Pi-mdi,-*-,bogvekolik-Pi-ndd,-*-,bogvekolik-Pi-ndi,-*-,bogvekolik-Pi-fdd,-*-,bogvekolik-Pi-fdi
bogvekolikimi	bogvekolik-Pi-mpi,-*-,bogvekolik-Pi-npi,-*-,bogvekolik-Pi-fpi
bogvekoliko	bogvekolik-Pi-nsn,-*-,bogvekolik-Pi-nsa,-*-,bogvekolik-Pi-fsi,-*-,bogvekolik-Pi-fsa
bogvekolikšen	bogvekolikšen-Pi-msn,-*-,bogvekolikšen-Pi-msa
bogvekolikšna	bogvekolikšen-Pi-mdn,-*-,bogvekolikšen-Pi-mda,-*-,bogvekolikšen-Pi-npn,-*-,bogvekolikšen-Pi-npa,-*-,bogvekolikšen-Pi-fsn
bogvekolikšne	bogvekolikšen-Pi-mpa,-*-,bogvekolikšen-Pi-fsg,-*-,bogvekolikšen-Pi-fpn,-*-,bogvekolikšen-Pi-fpa
bogvekolikšnega	bogvekolikšen-Pi-msg,-*-,bogvekolikšen-Pi-msa,-*-,bogvekolikšen-Pi-nsg
bogvekolikšnem	bogvekolikšen-Pi-msl,-*-,bogvekolikšen-Pi-nsl
bogvekolikšnemu	bogvekolikšen-Pi-msd,-*-,bogvekolikšen-Pi-nsd
bogvekolikšni	bogvekolikšen-Pi-mpn,-*-,bogvekolikšen-Pi-ndn,-*-,bogvekolikšen-Pi-nda,-*-,bogvekolikšen-Pi-fdn,-*-,bogvekolikšen-Pi-fda,-*-,bogvekolikšen-Pi-fsd,-*-,bogvekolikšen-Pi-fsl
bogvekolikšnih	bogvekolikšen-Pi-mdl,-*-,bogvekolikšen-Pi-mdg,-*-,bogvekolikšen-Pi-mpl,-*-,bogvekolikšen-Pi-mpg,-*-,bogvekolikšen-Pi-ndl,-*-,bogvekolikšen-Pi-ndg,-*-,bogvekolikšen-Pi-npl,-*-,bogvekolikšen-Pi-npg,-*-,bogvekolikšen-Pi-fdl,-*-,bogvekolikšen-Pi-fdg,-*-,bogvekolikšen-Pi-fpl,-*-,bogvekolikšen-Pi-fpg
bogvekolikšnim	bogvekolikšen-Pi-msi,-*-,bogvekolikšen-Pi-mpd,-*-,bogvekolikšen-Pi-nsi,-*-,bogvekolikšen-Pi-npd,-*-,bogvekolikšen-Pi-fpd
bogvekolikšnima	bogvekolikšen-Pi-mdd,-*-,bogvekolikšen-Pi-mdi,-*-,bogvekolikšen-Pi-ndd,-*-,bogvekolikšen-Pi-ndi,-*-,bogvekolikšen-Pi-fdd,-*-,bogvekolikšen-Pi-fdi
bogvekolikšnimi	bogvekolikšen-Pi-mpi,-*-,bogvekolikšen-Pi-npi,-*-,bogvekolikšen-Pi-fpi
bogvekolikšno	bogvekolikšen-Pi-nsn,-*-,bogvekolikšen-Pi-nsa,-*-,bogvekolikšen-Pi-fsi,-*-,bogvekolikšen-Pi-fsa
bogvečem	bogvekaj-Pi-nsl
bogvečemu	bogvekaj-Pi-nsd
bogvečesa	bogvekaj-Pi-nsg
bogvečim	bogvekaj-Pi-nsi
enak	enak-Pi-msn,-*-,enak-Pi-msa
enaka	enak-Pi-mdn,-*-,enak-Pi-mda,-*-,enak-Pi-npn,-*-,enak-Pi-npa,-*-,enak-Pi-fsn
enake	enak-Pi-mpa,-*-,enak-Pi-fsg,-*-,enak-Pi-fpn,-*-,enak-Pi-fpa
enakega	enak-Pi-msg,-*-,enak-Pi-msa,-*-,enak-Pi-nsg
enakem	enak-Pi-msl,-*-,enak-Pi-nsl
enakemu	enak-Pi-msd,-*-,enak-Pi-nsd
enaki	enak-Pi-mpn,-*-,enak-Pi-ndn,-*-,enak-Pi-nda,-*-,enak-Pi-fdn,-*-,enak-Pi-fda,-*-,enak-Pi-fsd,-*-,enak-Pi-fsl,-*-,enaki-Pi-msn
enakih	enak-Pi-mdl,-*-,enak-Pi-mdg,-*-,enak-Pi-mpl,-*-,enak-Pi-mpg,-*-,enak-Pi-ndl,-*-,enak-Pi-ndg,-*-,enak-Pi-npl,-*-,enak-Pi-npg,-*-,enak-Pi-fdl,-*-,enak-Pi-fdg,-*-,enak-Pi-fpl,-*-,enak-Pi-fpg
enakim	enak-Pi-msi,-*-,enak-Pi-mpd,-*-,enak-Pi-nsi,-*-,enak-Pi-npd,-*-,enak-Pi-fpd
enakima	enak-Pi-mdd,-*-,enak-Pi-mdi,-*-,enak-Pi-ndd,-*-,enak-Pi-ndi,-*-,enak-Pi-fdd,-*-,enak-Pi-fdi
enakimi	enak-Pi-mpi,-*-,enak-Pi-npi,-*-,enak-Pi-fpi
enako	enak-Pi-nsn,-*-,enak-Pi-nsa,-*-,enak-Pi-fsi,-*-,enak-Pi-fsa
enakšen	enakšen-Pi-msn,-*-,enakšen-Pi-msa
enakšna	enakšen-Pi-mdn,-*-,enakšen-Pi-mda,-*-,enakšen-Pi-npn,-*-,enakšen-Pi-npa,-*-,enakšen-Pi-fsn
enakšne	enakšen-Pi-mpa,-*-,enakšen-Pi-fsg,-*-,enakšen-Pi-fpn,-*-,enakšen-Pi-fpa
enakšnega	enakšen-Pi-msg,-*-,enakšen-Pi-msa,-*-,enakšen-Pi-nsg
enakšnem	enakšen-Pi-msl,-*-,enakšen-Pi-nsl
enakšnemu	enakšen-Pi-msd,-*-,enakšen-Pi-nsd
enakšni	enakšen-Pi-mpn,-*-,enakšen-Pi-ndn,-*-,enakšen-Pi-nda,-*-,enakšen-Pi-fdn,-*-,enakšen-Pi-fda,-*-,enakšen-Pi-fsd,-*-,enakšen-Pi-fsl
enakšnih	enakšen-Pi-mdl,-*-,enakšen-Pi-mdg,-*-,enakšen-Pi-mpl,-*-,enakšen-Pi-mpg,-*-,enakšen-Pi-ndl,-*-,enakšen-Pi-ndg,-*-,enakšen-Pi-npl,-*-,enakšen-Pi-npg,-*-,enakšen-Pi-fdl,-*-,enakšen-Pi-fdg,-*-,enakšen-Pi-fpl,-*-,enakšen-Pi-fpg
enakšnim	enakšen-Pi-msi,-*-,enakšen-Pi-mpd,-*-,enakšen-Pi-nsi,-*-,enakšen-Pi-npd,-*-,enakšen-Pi-fpd
enakšnima	enakšen-Pi-mdd,-*-,enakšen-Pi-mdi,-*-,enakšen-Pi-ndd,-*-,enakšen-Pi-ndi,-*-,enakšen-Pi-fdd,-*-,enakšen-Pi-fdi
enakšnimi	enakšen-Pi-mpi,-*-,enakšen-Pi-npi,-*-,enakšen-Pi-fpi
enakšno	enakšen-Pi-nsn,-*-,enakšen-Pi-nsa,-*-,enakšen-Pi-fsi,-*-,enakšen-Pi-fsa
ga	on-Pp3msg--y,-*-,on-Pp3msa--y,-*-,on-Pp3nsg--y,-*-,on-Pp3nsa--y
ista	isti-Pi-mdn,-*-,isti-Pi-mda,-*-,isti-Pi-npn,-*-,isti-Pi-npa,-*-,isti-Pi-fsn
iste	isti-Pi-mpa,-*-,isti-Pi-fsg,-*-,isti-Pi-fpn,-*-,isti-Pi-fpa
istega	isti-Pi-msg,-*-,isti-Pi-msa,-*-,isti-Pi-nsg
istem	isti-Pi-msl,-*-,isti-Pi-nsl
istemu	isti-Pi-msd,-*-,isti-Pi-nsd
isti	isti-Pi-msn,-*-,isti-Pi-msa,-*-,isti-Pi-mpn,-*-,isti-Pi-ndn,-*-,isti-Pi-nda,-*-,isti-Pi-fdn,-*-,isti-Pi-fda,-*-,isti-Pi-fsd,-*-,isti-Pi-fsl
istih	isti-Pi-mdl,-*-,isti-Pi-mdg,-*-,isti-Pi-mpl,-*-,isti-Pi-mpg,-*-,isti-Pi-ndl,-*-,isti-Pi-ndg,-*-,isti-Pi-npl,-*-,isti-Pi-npg,-*-,isti-Pi-fdl,-*-,isti-Pi-fdg,-*-,isti-Pi-fpl,-*-,isti-Pi-fpg
istim	isti-Pi-msi,-*-,isti-Pi-mpd,-*-,isti-Pi-nsi,-*-,isti-Pi-npd,-*-,isti-Pi-fpd
istima	isti-Pi-mdd,-*-,isti-Pi-mdi,-*-,isti-Pi-ndd,-*-,isti-Pi-ndi,-*-,isti-Pi-fdd,-*-,isti-Pi-fdi
istimi	isti-Pi-mpi,-*-,isti-Pi-npi,-*-,isti-Pi-fpi
isto	isti-Pi-nsn,-*-,isti-Pi-nsa,-*-,isti-Pi-fsi,-*-,isti-Pi-fsa
jaz	jaz-Pp1-sn
je	on-Pp3fsg--y
ji	on-Pp3fsd--y
jih	on-Pp3mdg--y,-*-,on-Pp3mda--y,-*-,on-Pp3mpg--y,-*-,on-Pp3mpa--y,-*-,on-Pp3ndg--y,-*-,on-Pp3nda--y,-*-,on-Pp3npg--y,-*-,on-Pp3npa--y,-*-,on-Pp3fdg--y,-*-,on-Pp3fda--y,-*-,on-Pp3fpg--y,-*-,on-Pp3fpa--y
jim	on-Pp3mpd--y,-*-,on-Pp3npd--y,-*-,on-Pp3fpd--y
jima	on-Pp3mdd--y,-*-,on-Pp3ndd--y,-*-,on-Pp3fdd--y
jo	on-Pp3fsa--y
ju	on-Pp3mdg--y,-*-,on-Pp3mda--y,-*-,on-Pp3ndg--y,-*-,on-Pp3nda--y,-*-,on-Pp3fdg--y,-*-,on-Pp3fda--y
kaj	kaj-Pq-nsn,-*-,kaj-Pq-nsa
kak	kak-Pq-msn,-*-,kak-Pq-msa
kaka	kak-Pq-mdn,-*-,kak-Pq-mda,-*-,kak-Pq-npn,-*-,kak-Pq-npa,-*-,kak-Pq-fsn
kake	kak-Pq-mpa,-*-,kak-Pq-fsg,-*-,kak-Pq-fpn,-*-,kak-Pq-fpa
kakega	kak-Pq-msg,-*-,kak-Pq-msa,-*-,kak-Pq-nsg
kakem	kak-Pq-msl,-*-,kak-Pq-nsl
kakemu	kak-Pq-msd,-*-,kak-Pq-nsd
kaki	kak-Pq-mpn,-*-,kak-Pq-ndn,-*-,kak-Pq-nda,-*-,kak-Pq-fdn,-*-,kak-Pq-fda,-*-,kak-Pq-fsd,-*-,kak-Pq-fsl
kakih	kak-Pq-mdl,-*-,kak-Pq-mdg,-*-,kak-Pq-mpl,-*-,kak-Pq-mpg,-*-,kak-Pq-ndl,-*-,kak-Pq-ndg,-*-,kak-Pq-npl,-*-,kak-Pq-npg,-*-,kak-Pq-fdl,-*-,kak-Pq-fdg,-*-,kak-Pq-fpl,-*-,kak-Pq-fpg
kakim	kak-Pq-msi,-*-,kak-Pq-mpd,-*-,kak-Pq-nsi,-*-,kak-Pq-npd,-*-,kak-Pq-fpd
kakima	kak-Pq-mdd,-*-,kak-Pq-mdi,-*-,kak-Pq-ndd,-*-,kak-Pq-ndi,-*-,kak-Pq-fdd,-*-,kak-Pq-fdi
kakimi	kak-Pq-mpi,-*-,kak-Pq-npi,-*-,kak-Pq-fpi
kako	kak-Pq-nsn,-*-,kak-Pq-nsa,-*-,kak-Pq-fsi,-*-,kak-Pq-fsa
kakov	kakov-Pq-msn,-*-,kakov-Pq-msa
kakova	kakov-Pq-mdn,-*-,kakov-Pq-mda,-*-,kakov-Pq-npn,-*-,kakov-Pq-npa,-*-,kakov-Pq-fsn
kakove	kakov-Pq-mpa,-*-,kakov-Pq-fsg,-*-,kakov-Pq-fpn,-*-,kakov-Pq-fpa
kakovega	kakov-Pq-msg,-*-,kakov-Pq-msa,-*-,kakov-Pq-nsg
kakovem	kakov-Pq-msl,-*-,kakov-Pq-nsl
kakovemu	kakov-Pq-msd,-*-,kakov-Pq-nsd
kakovi	kakov-Pq-mpn,-*-,kakov-Pq-ndn,-*-,kakov-Pq-nda,-*-,kakov-Pq-fdn,-*-,kakov-Pq-fda,-*-,kakov-Pq-fsd,-*-,kakov-Pq-fsl
kakovih	kakov-Pq-mdl,-*-,kakov-Pq-mdg,-*-,kakov-Pq-mpl,-*-,kakov-Pq-mpg,-*-,kakov-Pq-ndl,-*-,kakov-Pq-ndg,-*-,kakov-Pq-npl,-*-,kakov-Pq-npg,-*-,kakov-Pq-fdl,-*-,kakov-Pq-fdg,-*-,kakov-Pq-fpl,-*-,kakov-Pq-fpg
kakovim	kakov-Pq-msi,-*-,kakov-Pq-mpd,-*-,kakov-Pq-nsi,-*-,kakov-Pq-npd,-*-,kakov-Pq-fpd
kakovima	kakov-Pq-mdd,-*-,kakov-Pq-mdi,-*-,kakov-Pq-ndd,-*-,kakov-Pq-ndi,-*-,kakov-Pq-fdd,-*-,kakov-Pq-fdi
kakovimi	kakov-Pq-mpi,-*-,kakov-Pq-npi,-*-,kakov-Pq-fpi
kakovo	kakov-Pq-nsn,-*-,kakov-Pq-nsa,-*-,kakov-Pq-fsi,-*-,kakov-Pq-fsa
kakošen	kakošen-Pq-msn,-*-,kakošen-Pq-msa
kakošna	kakošen-Pq-mdn,-*-,kakošen-Pq-mda,-*-,kakošen-Pq-npn,-*-,kakošen-Pq-npa,-*-,kakošen-Pq-fsn
kakošne	kakošen-Pq-mpa,-*-,kakošen-Pq-fsg,-*-,kakošen-Pq-fpn,-*-,kakošen-Pq-fpa
kakošnega	kakošen-Pq-msg,-*-,kakošen-Pq-msa,-*-,kakošen-Pq-nsg
kakošnem	kakošen-Pq-msl,-*-,kakošen-Pq-nsl
kakošnemu	kakošen-Pq-msd,-*-,kakošen-Pq-nsd
kakošni	kakošen-Pq-mpn,-*-,kakošen-Pq-ndn,-*-,kakošen-Pq-nda,-*-,kakošen-Pq-fdn,-*-,kakošen-Pq-fda,-*-,kakošen-Pq-fsd,-*-,kakošen-Pq-fsl
kakošnih	kakošen-Pq-mdl,-*-,kakošen-Pq-mdg,-*-,kakošen-Pq-mpl,-*-,kakošen-Pq-mpg,-*-,kakošen-Pq-ndl,-*-,kakošen-Pq-ndg,-*-,kakošen-Pq-npl,-*-,kakošen-Pq-npg,-*-,kakošen-Pq-fdl,-*-,kakošen-Pq-fdg,-*-,kakošen-Pq-fpl,-*-,kakošen-Pq-fpg
kakošnim	kakošen-Pq-msi,-*-,kakošen-Pq-mpd,-*-,kakošen-Pq-nsi,-*-,kakošen-Pq-npd,-*-,kakošen-Pq-fpd
kakošnima	kakošen-Pq-mdd,-*-,kakošen-Pq-mdi,-*-,kakošen-Pq-ndd,-*-,kakošen-Pq-ndi,-*-,kakošen-Pq-fdd,-*-,kakošen-Pq-fdi
kakošnimi	kakošen-Pq-mpi,-*-,kakošen-Pq-npi,-*-,kakošen-Pq-fpi
kakošno	kakošen-Pq-nsn,-*-,kakošen-Pq-nsa,-*-,kakošen-Pq-fsi,-*-,kakošen-Pq-fsa
kakršen	kakršen-Pr-msn,-*-,kakršen-Pr-msa
kakršenkoli	kakršenkoli-Pr-msn,-*-,kakršenkoli-Pr-msa
kakršensižebodi	kakršensižebodi-Pr-msn,-*-,kakršensižebodi-Pr-msa
kakršna	kakršen-Pr-mdn,-*-,kakršen-Pr-mda,-*-,kakršen-Pr-npn,-*-,kakršen-Pr-npa,-*-,kakršen-Pr-fsn
kakršnakoli	kakršenkoli-Pr-mdn,-*-,kakršenkoli-Pr-mda,-*-,kakršenkoli-Pr-npn,-*-,kakršenkoli-Pr-npa,-*-,kakršenkoli-Pr-fsn
kakršnasižebodi	kakršensižebodi-Pr-mdn,-*-,kakršensižebodi-Pr-mda,-*-,kakršensižebodi-Pr-npn,-*-,kakršensižebodi-Pr-npa,-*-,kakršensižebodi-Pr-fsn
kakršne	kakršen-Pr-mpa,-*-,kakršen-Pr-fsg,-*-,kakršen-Pr-fpn,-*-,kakršen-Pr-fpa
kakršnega	kakršen-Pr-msg,-*-,kakršen-Pr-msa,-*-,kakršen-Pr-nsg,-*-,kakršen-Pr-nsa
kakršnegakoli	kakršenkoli-Pr-msg,-*-,kakršenkoli-Pr-msa,-*-,kakršenkoli-Pr-nsg
kakršnegasižebodi	kakršensižebodi-Pr-msg,-*-,kakršensižebodi-Pr-msa,-*-,kakršensižebodi-Pr-nsg
kakršnekoli	kakršenkoli-Pr-mpa,-*-,kakršenkoli-Pr-fsg,-*-,kakršenkoli-Pr-fpn,-*-,kakršenkoli-Pr-fpa
kakršnem	kakršen-Pr-msl,-*-,kakršen-Pr-nsl
kakršnemkoli	kakršenkoli-Pr-msl,-*-,kakršenkoli-Pr-nsl
kakršnemsižebodi	kakršensižebodi-Pr-msl,-*-,kakršensižebodi-Pr-nsl
kakršnemu	kakršen-Pr-msd,-*-,kakršen-Pr-nsd
kakršnemukoli	kakršenkoli-Pr-msd,-*-,kakršenkoli-Pr-nsd
kakršnemusižebodi	kakršensižebodi-Pr-msd,-*-,kakršensižebodi-Pr-nsd
kakršnesižebodi	kakršensižebodi-Pr-mpa,-*-,kakršensižebodi-Pr-fsg,-*-,kakršensižebodi-Pr-fpn,-*-,kakršensižebodi-Pr-fpa
kakršni	kakršen-Pr-mpn,-*-,kakršen-Pr-ndn,-*-,kakršen-Pr-nda,-*-,kakršen-Pr-fdn,-*-,kakršen-Pr-fda,-*-,kakršen-Pr-fsd,-*-,kakršen-Pr-fsl
kakršnih	kakršen-Pr-mdl,-*-,kakršen-Pr-mdg,-*-,kakršen-Pr-mpl,-*-,kakršen-Pr-mpg,-*-,kakršen-Pr-ndl,-*-,kakršen-Pr-ndg,-*-,kakršen-Pr-npl,-*-,kakršen-Pr-npg,-*-,kakršen-Pr-fdl,-*-,kakršen-Pr-fdg,-*-,kakršen-Pr-fpl,-*-,kakršen-Pr-fpg
kakršnihkoli	kakršenkoli-Pr-mdl,-*-,kakršenkoli-Pr-mdg,-*-,kakršenkoli-Pr-mpl,-*-,kakršenkoli-Pr-mpg,-*-,kakršenkoli-Pr-ndl,-*-,kakršenkoli-Pr-ndg,-*-,kakršenkoli-Pr-npl,-*-,kakršenkoli-Pr-npg,-*-,kakršenkoli-Pr-fdl,-*-,kakršenkoli-Pr-fdg,-*-,kakršenkoli-Pr-fpl,-*-,kakršenkoli-Pr-fpg
kakršnihsižebodi	kakršensižebodi-Pr-mdl,-*-,kakršensižebodi-Pr-mdg,-*-,kakršensižebodi-Pr-mpl,-*-,kakršensižebodi-Pr-mpg,-*-,kakršensižebodi-Pr-ndl,-*-,kakršensižebodi-Pr-ndg,-*-,kakršensižebodi-Pr-npl,-*-,kakršensižebodi-Pr-npg,-*-,kakršensižebodi-Pr-fdl,-*-,kakršensižebodi-Pr-fdg,-*-,kakršensižebodi-Pr-fpl,-*-,kakršensižebodi-Pr-fpg
kakršnikoli	kakršenkoli-Pr-mpn,-*-,kakršenkoli-Pr-ndn,-*-,kakršenkoli-Pr-nda,-*-,kakršenkoli-Pr-fdn,-*-,kakršenkoli-Pr-fda,-*-,kakršenkoli-Pr-fsd,-*-,kakršenkoli-Pr-fsl
kakršnim	kakršen-Pr-msi,-*-,kakršen-Pr-mpd,-*-,kakršen-Pr-nsi,-*-,kakršen-Pr-npd,-*-,kakršen-Pr-fpd
kakršnima	kakršen-Pr-mdd,-*-,kakršen-Pr-mdi,-*-,kakršen-Pr-ndd,-*-,kakršen-Pr-ndi,-*-,kakršen-Pr-fdd,-*-,kakršen-Pr-fdi
kakršnimakoli	kakršenkoli-Pr-mdd,-*-,kakršenkoli-Pr-mdi,-*-,kakršenkoli-Pr-ndd,-*-,kakršenkoli-Pr-ndi,-*-,kakršenkoli-Pr-fdd,-*-,kakršenkoli-Pr-fdi
kakršnimasižebodi	kakršensižebodi-Pr-mdd,-*-,kakršensižebodi-Pr-mdi,-*-,kakršensižebodi-Pr-ndd,-*-,kakršensižebodi-Pr-ndi,-*-,kakršensižebodi-Pr-fdd,-*-,kakršensižebodi-Pr-fdi
kakršnimi	kakršen-Pr-mpi,-*-,kakršen-Pr-npi,-*-,kakršen-Pr-fpi
kakršnimikoli	kakršenkoli-Pr-mpi,-*-,kakršenkoli-Pr-npi,-*-,kakršenkoli-Pr-fpi
kakršnimisižebodi	kakršensižebodi-Pr-mpi,-*-,kakršensižebodi-Pr-npi,-*-,kakršensižebodi-Pr-fpi
kakršnimkoli	kakršenkoli-Pr-msi,-*-,kakršenkoli-Pr-mpd,-*-,kakršenkoli-Pr-nsi,-*-,kakršenkoli-Pr-npd,-*-,kakršenkoli-Pr-fpd
kakršnimsižebodi	kakršensižebodi-Pr-msi,-*-,kakršensižebodi-Pr-mpd,-*-,kakršensižebodi-Pr-nsi,-*-,kakršensižebodi-Pr-npd,-*-,kakršensižebodi-Pr-fpd
kakršnisižebodi	kakršensižebodi-Pr-mpn,-*-,kakršensižebodi-Pr-ndn,-*-,kakršensižebodi-Pr-nda,-*-,kakršensižebodi-Pr-fdn,-*-,kakršensižebodi-Pr-fda,-*-,kakršensižebodi-Pr-fsd,-*-,kakršensižebodi-Pr-fsl
kakršno	kakršen-Pr-nsn,-*-,kakršen-Pr-nsa,-*-,kakršen-Pr-fsi,-*-,kakršen-Pr-fsa
kakršnokoli	kakršenkoli-Pr-nsn,-*-,kakršenkoli-Pr-nsa,-*-,kakršenkoli-Pr-fsi,-*-,kakršenkoli-Pr-fsa
kakršnosižebodi	kakršensižebodi-Pr-nsn,-*-,kakršensižebodi-Pr-nsa,-*-,kakršensižebodi-Pr-fsi,-*-,kakršensižebodi-Pr-fsa
kakšen	kakšen-Pq-msn,-*-,kakšen-Pq-msa
kakšna	kakšen-Pq-mdn,-*-,kakšen-Pq-mda,-*-,kakšen-Pq-npn,-*-,kakšen-Pq-npa,-*-,kakšen-Pq-fsn
kakšne	kakšen-Pq-mpa,-*-,kakšen-Pq-fsg,-*-,kakšen-Pq-fpn,-*-,kakšen-Pq-fpa
kakšnega	kakšen-Pq-msg,-*-,kakšen-Pq-msa,-*-,kakšen-Pq-nsg
kakšnem	kakšen-Pq-msl,-*-,kakšen-Pq-nsl
kakšnemu	kakšen-Pq-msd,-*-,kakšen-Pq-nsd
kakšni	kakšen-Pq-mpn,-*-,kakšen-Pq-ndn,-*-,kakšen-Pq-nda,-*-,kakšen-Pq-fdn,-*-,kakšen-Pq-fda,-*-,kakšen-Pq-fsd,-*-,kakšen-Pq-fsl
kakšnih	kakšen-Pq-mdl,-*-,kakšen-Pq-mdg,-*-,kakšen-Pq-mpl,-*-,kakšen-Pq-mpg,-*-,kakšen-Pq-ndl,-*-,kakšen-Pq-ndg,-*-,kakšen-Pq-npl,-*-,kakšen-Pq-npg,-*-,kakšen-Pq-fdl,-*-,kakšen-Pq-fdg,-*-,kakšen-Pq-fpl,-*-,kakšen-Pq-fpg
kakšnim	kakšen-Pq-msi,-*-,kakšen-Pq-mpd,-*-,kakšen-Pq-nsi,-*-,kakšen-Pq-npd,-*-,kakšen-Pq-fpd
kakšnima	kakšen-Pq-mdd,-*-,kakšen-Pq-mdi,-*-,kakšen-Pq-ndd,-*-,kakšen-Pq-ndi,-*-,kakšen-Pq-fdd,-*-,kakšen-Pq-fdi
kakšnimi	kakšen-Pq-mpi,-*-,kakšen-Pq-npi,-*-,kakšen-Pq-fpi
kakšno	kakšen-Pq-nsn,-*-,kakšen-Pq-nsa,-*-,kakšen-Pq-fsi,-*-,kakšen-Pq-fsa
kar	kar-Pr-nsn,-*-,kar-Pr-nsa
karkoli	karkoli-Pr-nsn,-*-,karkoli-Pr-nsa
karsibodi	karsibodi-Pr-nsn,-*-,karsibodi-Pr-nsa
karsižebodi	karsižebodi-Pr-nsn,-*-,karsižebodi-Pr-nsa
katera	kateri-Pq-mdn,-*-,kateri-Pq-mda,-*-,kateri-Pq-npn,-*-,kateri-Pq-npa,-*-,kateri-Pq-fsn
katerakoli	katerikoli-Pr-mdn,-*-,katerikoli-Pr-mda,-*-,katerikoli-Pr-npn,-*-,katerikoli-Pr-npa,-*-,katerikoli-Pr-fsn
katerasibodi	katerisibodi-Pr-mdn,-*-,katerisibodi-Pr-mda,-*-,katerisibodi-Pr-npn,-*-,katerisibodi-Pr-npa,-*-,katerisibodi-Pr-fsn
katere	kateri-Pq-mpa,-*-,kateri-Pq-fsg,-*-,kateri-Pq-fpn,-*-,kateri-Pq-fpa
katerega	kateri-Pq-msg,-*-,kateri-Pq-msa,-*-,kateri-Pq-nsg,-*-,kateri-Pq-nsa
kateregakoli	katerikoli-Pr-msg,-*-,katerikoli-Pr-msa,-*-,katerikoli-Pr-nsg
kateregasibodi	katerisibodi-Pr-msg,-*-,katerisibodi-Pr-msa,-*-,katerisibodi-Pr-nsg
katerekoli	katerikoli-Pr-mpa,-*-,katerikoli-Pr-fsg,-*-,katerikoli-Pr-fpn,-*-,katerikoli-Pr-fpa
katerem	kateri-Pq-msl,-*-,kateri-Pq-nsl
kateremkoli	katerikoli-Pr-msl,-*-,katerikoli-Pr-nsl
kateremsibodi	katerisibodi-Pr-msl,-*-,katerisibodi-Pr-nsl
kateremu	kateri-Pq-msd,-*-,kateri-Pq-nsd
kateremukoli	katerikoli-Pr-msd,-*-,katerikoli-Pr-nsd
kateremusibodi	katerisibodi-Pr-msd,-*-,katerisibodi-Pr-nsd
kateresibodi	katerisibodi-Pr-mpa,-*-,katerisibodi-Pr-fsg,-*-,katerisibodi-Pr-fpn,-*-,katerisibodi-Pr-fpa
kateri	kateri-Pq-msn,-*-,kateri-Pq-msa,-*-,kateri-Pq-mpn,-*-,kateri-Pq-ndn,-*-,kateri-Pq-nda,-*-,kateri-Pq-fdn,-*-,kateri-Pq-fda,-*-,kateri-Pq-fsd,-*-,kateri-Pq-fsl
katerih	kateri-Pq-mdl,-*-,kateri-Pq-mdg,-*-,kateri-Pq-mpl,-*-,kateri-Pq-mpg,-*-,kateri-Pq-ndl,-*-,kateri-Pq-ndg,-*-,kateri-Pq-npl,-*-,kateri-Pq-npg,-*-,kateri-Pq-fdl,-*-,kateri-Pq-fdg,-*-,kateri-Pq-fpl,-*-,kateri-Pq-fpg
katerihkoli	katerikoli-Pr-mdl,-*-,katerikoli-Pr-mdg,-*-,katerikoli-Pr-mpl,-*-,katerikoli-Pr-mpg,-*-,katerikoli-Pr-ndl,-*-,katerikoli-Pr-ndg,-*-,katerikoli-Pr-npl,-*-,katerikoli-Pr-npg,-*-,katerikoli-Pr-fdl,-*-,katerikoli-Pr-fdg,-*-,katerikoli-Pr-fpl,-*-,katerikoli-Pr-fpg
katerihsibodi	katerisibodi-Pr-mdl,-*-,katerisibodi-Pr-mdg,-*-,katerisibodi-Pr-mpl,-*-,katerisibodi-Pr-mpg,-*-,katerisibodi-Pr-ndl,-*-,katerisibodi-Pr-ndg,-*-,katerisibodi-Pr-npl,-*-,katerisibodi-Pr-npg,-*-,katerisibodi-Pr-fdl,-*-,katerisibodi-Pr-fdg,-*-,katerisibodi-Pr-fpl,-*-,katerisibodi-Pr-fpg
katerikoli	katerikoli-Pr-msn,-*-,katerikoli-Pr-msa,-*-,katerikoli-Pr-mpn,-*-,katerikoli-Pr-ndn,-*-,katerikoli-Pr-nda,-*-,katerikoli-Pr-fdn,-*-,katerikoli-Pr-fda,-*-,katerikoli-Pr-fsd,-*-,katerikoli-Pr-fsl
katerim	kateri-Pq-msi,-*-,kateri-Pq-mpd,-*-,kateri-Pq-nsi,-*-,kateri-Pq-npd,-*-,kateri-Pq-fpd
katerima	kateri-Pq-mdd,-*-,kateri-Pq-mdi,-*-,kateri-Pq-ndd,-*-,kateri-Pq-ndi,-*-,kateri-Pq-fdd,-*-,kateri-Pq-fdi
katerimakoli	katerikoli-Pr-mdd,-*-,katerikoli-Pr-mdi,-*-,katerikoli-Pr-ndd,-*-,katerikoli-Pr-ndi,-*-,katerikoli-Pr-fdd,-*-,katerikoli-Pr-fdi
katerimasibodi	katerisibodi-Pr-mdd,-*-,katerisibodi-Pr-mdi,-*-,katerisibodi-Pr-ndd,-*-,katerisibodi-Pr-ndi,-*-,katerisibodi-Pr-fdd,-*-,katerisibodi-Pr-fdi
katerimi	kateri-Pq-mpi,-*-,kateri-Pq-npi,-*-,kateri-Pq-fpi
katerimikoli	katerikoli-Pr-mpi,-*-,katerikoli-Pr-npi,-*-,katerikoli-Pr-fpi
katerimisibodi	katerisibodi-Pr-mpi,-*-,katerisibodi-Pr-npi,-*-,katerisibodi-Pr-fpi
katerimkoli	katerikoli-Pr-msi,-*-,katerikoli-Pr-mpd,-*-,katerikoli-Pr-nsi,-*-,katerikoli-Pr-npd,-*-,katerikoli-Pr-fpd
katerimsibodi	katerisibodi-Pr-msi,-*-,katerisibodi-Pr-mpd,-*-,katerisibodi-Pr-nsi,-*-,katerisibodi-Pr-npd,-*-,katerisibodi-Pr-fpd
katerisibodi	katerisibodi-Pr-msn,-*-,katerisibodi-Pr-msa,-*-,katerisibodi-Pr-mpn,-*-,katerisibodi-Pr-ndn,-*-,katerisibodi-Pr-nda,-*-,katerisibodi-Pr-fdn,-*-,katerisibodi-Pr-fda,-*-,katerisibodi-Pr-fsd,-*-,katerisibodi-Pr-fsl
katero	kateri-Pq-nsn,-*-,kateri-Pq-nsa,-*-,kateri-Pq-fsi,-*-,kateri-Pq-fsa
katerokoli	katerikoli-Pr-nsn,-*-,katerikoli-Pr-nsa,-*-,katerikoli-Pr-fsi,-*-,katerikoli-Pr-fsa
katerosibodi	katerisibodi-Pr-nsn,-*-,katerisibodi-Pr-nsa,-*-,katerisibodi-Pr-fsi,-*-,katerisibodi-Pr-fsa
kdo	kdo-Pq-msn
kdor	kdor-Pr-msn
kdorkoli	kdorkoli-Pr-msn
kdorsibodi	kdorsibodi-Pr-msn
kdorsižebodi	kdorsižebodi-Pr-msn
kdovekaj	kdovekaj-Pi-nsn,-*-,kdovekaj-Pi-nsa
kdovekak	kdovekak-Pi-msn,-*-,kdovekak-Pi-msa
kdovekaka	kdovekak-Pi-mdn,-*-,kdovekak-Pi-mda,-*-,kdovekak-Pi-npn,-*-,kdovekak-Pi-npa,-*-,kdovekak-Pi-fsn
kdovekake	kdovekak-Pi-mpa,-*-,kdovekak-Pi-fsg,-*-,kdovekak-Pi-fpn,-*-,kdovekak-Pi-fpa
kdovekakega	kdovekak-Pi-msg,-*-,kdovekak-Pi-msa,-*-,kdovekak-Pi-nsg
kdovekakem	kdovekak-Pi-msl,-*-,kdovekak-Pi-nsl
kdovekakemu	kdovekak-Pi-msd,-*-,kdovekak-Pi-nsd
kdovekaki	kdovekak-Pi-mpn,-*-,kdovekak-Pi-ndn,-*-,kdovekak-Pi-nda,-*-,kdovekak-Pi-fdn,-*-,kdovekak-Pi-fda,-*-,kdovekak-Pi-fsd,-*-,kdovekak-Pi-fsl
kdovekakih	kdovekak-Pi-mdl,-*-,kdovekak-Pi-mdg,-*-,kdovekak-Pi-mpl,-*-,kdovekak-Pi-mpg,-*-,kdovekak-Pi-ndl,-*-,kdovekak-Pi-ndg,-*-,kdovekak-Pi-npl,-*-,kdovekak-Pi-npg,-*-,kdovekak-Pi-fdl,-*-,kdovekak-Pi-fdg,-*-,kdovekak-Pi-fpl,-*-,kdovekak-Pi-fpg
kdovekakim	kdovekak-Pi-msi,-*-,kdovekak-Pi-mpd,-*-,kdovekak-Pi-nsi,-*-,kdovekak-Pi-npd,-*-,kdovekak-Pi-fpd
kdovekakima	kdovekak-Pi-mdd,-*-,kdovekak-Pi-mdi,-*-,kdovekak-Pi-ndd,-*-,kdovekak-Pi-ndi,-*-,kdovekak-Pi-fdd,-*-,kdovekak-Pi-fdi
kdovekakimi	kdovekak-Pi-mpi,-*-,kdovekak-Pi-npi,-*-,kdovekak-Pi-fpi
kdovekako	kdovekak-Pi-nsn,-*-,kdovekak-Pi-nsa,-*-,kdovekak-Pi-fsi,-*-,kdovekak-Pi-fsa
kdovekakšen	kdovekakšen-Pi-msn,-*-,kdovekakšen-Pi-msa
kdovekakšna	kdovekakšen-Pi-mdn,-*-,kdovekakšen-Pi-mda,-*-,kdovekakšen-Pi-npn,-*-,kdovekakšen-Pi-npa,-*-,kdovekakšen-Pi-fsn
kdovekakšne	kdovekakšen-Pi-mpa,-*-,kdovekakšen-Pi-fsg,-*-,kdovekakšen-Pi-fpn,-*-,kdovekakšen-Pi-fpa
kdovekakšnega	kdovekakšen-Pi-msg,-*-,kdovekakšen-Pi-msa,-*-,kdovekakšen-Pi-nsg
kdovekakšnem	kdovekakšen-Pi-msl,-*-,kdovekakšen-Pi-nsl
kdovekakšnemu	kdovekakšen-Pi-msd,-*-,kdovekakšen-Pi-nsd
kdovekakšni	kdovekakšen-Pi-mpn,-*-,kdovekakšen-Pi-ndn,-*-,kdovekakšen-Pi-nda,-*-,kdovekakšen-Pi-fdn,-*-,kdovekakšen-Pi-fda,-*-,kdovekakšen-Pi-fsd,-*-,kdovekakšen-Pi-fsl
kdovekakšnih	kdovekakšen-Pi-mdl,-*-,kdovekakšen-Pi-mdg,-*-,kdovekakšen-Pi-mpl,-*-,kdovekakšen-Pi-mpg,-*-,kdovekakšen-Pi-ndl,-*-,kdovekakšen-Pi-ndg,-*-,kdovekakšen-Pi-npl,-*-,kdovekakšen-Pi-npg,-*-,kdovekakšen-Pi-fdl,-*-,kdovekakšen-Pi-fdg,-*-,kdovekakšen-Pi-fpl,-*-,kdovekakšen-Pi-fpg
kdovekakšnim	kdovekakšen-Pi-msi,-*-,kdovekakšen-Pi-mpd,-*-,kdovekakšen-Pi-nsi,-*-,kdovekakšen-Pi-npd,-*-,kdovekakšen-Pi-fpd
kdovekakšnima	kdovekakšen-Pi-mdd,-*-,kdovekakšen-Pi-mdi,-*-,kdovekakšen-Pi-ndd,-*-,kdovekakšen-Pi-ndi,-*-,kdovekakšen-Pi-fdd,-*-,kdovekakšen-Pi-fdi
kdovekakšnimi	kdovekakšen-Pi-mpi,-*-,kdovekakšen-Pi-npi,-*-,kdovekakšen-Pi-fpi
kdovekakšno	kdovekakšen-Pi-nsn,-*-,kdovekakšen-Pi-nsa,-*-,kdovekakšen-Pi-fsi,-*-,kdovekakšen-Pi-fsa
kdovekatera	kdovekateri-Pi-mdn,-*-,kdovekateri-Pi-mda,-*-,kdovekateri-Pi-npn,-*-,kdovekateri-Pi-npa,-*-,kdovekateri-Pi-fsn
kdovekatere	kdovekateri-Pi-mpa,-*-,kdovekateri-Pi-fsg,-*-,kdovekateri-Pi-fpn,-*-,kdovekateri-Pi-fpa
kdovekaterega	kdovekateri-Pi-msg,-*-,kdovekateri-Pi-msa,-*-,kdovekateri-Pi-nsg
kdovekaterem	kdovekateri-Pi-msl,-*-,kdovekateri-Pi-nsl
kdovekateremu	kdovekateri-Pi-msd,-*-,kdovekateri-Pi-nsd
kdovekateri	kdovekateri-Pi-msn,-*-,kdovekateri-Pi-msa,-*-,kdovekateri-Pi-mpn,-*-,kdovekateri-Pi-ndn,-*-,kdovekateri-Pi-nda,-*-,kdovekateri-Pi-fdn,-*-,kdovekateri-Pi-fda,-*-,kdovekateri-Pi-fsd,-*-,kdovekateri-Pi-fsl
kdovekaterih	kdovekateri-Pi-mdl,-*-,kdovekateri-Pi-mdg,-*-,kdovekateri-Pi-mpl,-*-,kdovekateri-Pi-mpg,-*-,kdovekateri-Pi-ndl,-*-,kdovekateri-Pi-ndg,-*-,kdovekateri-Pi-npl,-*-,kdovekateri-Pi-npg,-*-,kdovekateri-Pi-fdl,-*-,kdovekateri-Pi-fdg,-*-,kdovekateri-Pi-fpl,-*-,kdovekateri-Pi-fpg
kdovekaterim	kdovekateri-Pi-msi,-*-,kdovekateri-Pi-mpd,-*-,kdovekateri-Pi-nsi,-*-,kdovekateri-Pi-npd,-*-,kdovekateri-Pi-fpd
kdovekaterima	kdovekateri-Pi-mdd,-*-,kdovekateri-Pi-mdi,-*-,kdovekateri-Pi-ndd,-*-,kdovekateri-Pi-ndi,-*-,kdovekateri-Pi-fdd,-*-,kdovekateri-Pi-fdi
kdovekaterimi	kdovekateri-Pi-mpi,-*-,kdovekateri-Pi-npi,-*-,kdovekateri-Pi-fpi
kdovekatero	kdovekateri-Pi-nsn,-*-,kdovekateri-Pi-nsa,-*-,kdovekateri-Pi-fsi,-*-,kdovekateri-Pi-fsa
kdovekdo	kdovekdo-Pi-msn
kdovekoga	kdovekdo-Pi-msg,-*-,kdovekdo-Pi-msa
kdovekolik	kdovekolik-Pi-msn,-*-,kdovekolik-Pi-msa
kdovekolika	kdovekolik-Pi-mdn,-*-,kdovekolik-Pi-mda,-*-,kdovekolik-Pi-npn,-*-,kdovekolik-Pi-npa,-*-,kdovekolik-Pi-fsn
kdovekolike	kdovekolik-Pi-mpa,-*-,kdovekolik-Pi-fsg,-*-,kdovekolik-Pi-fpn,-*-,kdovekolik-Pi-fpa
kdovekolikega	kdovekolik-Pi-msg,-*-,kdovekolik-Pi-msa,-*-,kdovekolik-Pi-nsg
kdovekolikem	kdovekolik-Pi-msl,-*-,kdovekolik-Pi-nsl
kdovekolikemu	kdovekolik-Pi-msd,-*-,kdovekolik-Pi-nsd
kdovekoliki	kdovekolik-Pi-mpn,-*-,kdovekolik-Pi-ndn,-*-,kdovekolik-Pi-nda,-*-,kdovekolik-Pi-fdn,-*-,kdovekolik-Pi-fda,-*-,kdovekolik-Pi-fsd,-*-,kdovekolik-Pi-fsl
kdovekolikih	kdovekolik-Pi-mdl,-*-,kdovekolik-Pi-mdg,-*-,kdovekolik-Pi-mpl,-*-,kdovekolik-Pi-mpg,-*-,kdovekolik-Pi-ndl,-*-,kdovekolik-Pi-ndg,-*-,kdovekolik-Pi-npl,-*-,kdovekolik-Pi-npg,-*-,kdovekolik-Pi-fdl,-*-,kdovekolik-Pi-fdg,-*-,kdovekolik-Pi-fpl,-*-,kdovekolik-Pi-fpg
kdovekolikim	kdovekolik-Pi-msi,-*-,kdovekolik-Pi-mpd,-*-,kdovekolik-Pi-nsi,-*-,kdovekolik-Pi-npd,-*-,kdovekolik-Pi-fpd
kdovekolikima	kdovekolik-Pi-mdd,-*-,kdovekolik-Pi-mdi,-*-,kdovekolik-Pi-ndd,-*-,kdovekolik-Pi-ndi,-*-,kdovekolik-Pi-fdd,-*-,kdovekolik-Pi-fdi
kdovekolikimi	kdovekolik-Pi-mpi,-*-,kdovekolik-Pi-npi,-*-,kdovekolik-Pi-fpi
kdovekoliko	kdovekolik-Pi-nsn,-*-,kdovekolik-Pi-nsa,-*-,kdovekolik-Pi-fsi,-*-,kdovekolik-Pi-fsa
kdovekom	kdovekdo-Pi-msl,-*-,kdovekdo-Pi-msi
kdovekomu	kdovekdo-Pi-msd
kdovečem	kdovekaj-Pi-nsl
kdovečemu	kdovekaj-Pi-nsd
kdovečesa	kdovekaj-Pi-nsg
kdovečim	kdovekaj-Pi-nsi
koga	kdo-Pq-msg,-*-,kdo-Pq-msa
kogar	kdor-Pr-msg,-*-,kdor-Pr-msa
kogarkoli	kdorkoli-Pr-msg,-*-,kdorkoli-Pr-msa
kogarsibodi	kdorsibodi-Pr-msg,-*-,kdorsibodi-Pr-msa
kogarsižebodi	kdorsižebodi-Pr-msg,-*-,kdorsižebodi-Pr-msa
koja	koji-Pq-mdn,-*-,koji-Pq-mda,-*-,koji-Pq-npn,-*-,koji-Pq-npa,-*-,koji-Pq-fsn
koje	koji-Pq-mpa,-*-,koji-Pq-nsn,-*-,koji-Pq-nsa,-*-,koji-Pq-fsg,-*-,koji-Pq-fpn,-*-,koji-Pq-fpa
kojega	koji-Pq-msg,-*-,koji-Pq-msa,-*-,koji-Pq-nsg
kojem	koji-Pq-msl,-*-,koji-Pq-nsl
kojemu	koji-Pq-msd,-*-,koji-Pq-nsd
koji	koji-Pq-msn,-*-,koji-Pq-msa,-*-,koji-Pq-mpn,-*-,koji-Pq-ndn,-*-,koji-Pq-nda,-*-,koji-Pq-fdn,-*-,koji-Pq-fda,-*-,koji-Pq-fsd,-*-,koji-Pq-fsl
kojih	koji-Pq-mdl,-*-,koji-Pq-mdg,-*-,koji-Pq-mpl,-*-,koji-Pq-mpg,-*-,koji-Pq-ndl,-*-,koji-Pq-ndg,-*-,koji-Pq-npl,-*-,koji-Pq-npg,-*-,koji-Pq-fdl,-*-,koji-Pq-fdg,-*-,koji-Pq-fpl,-*-,koji-Pq-fpg
kojim	koji-Pq-msi,-*-,koji-Pq-mpd,-*-,koji-Pq-nsi,-*-,koji-Pq-npd,-*-,koji-Pq-fpd
kojima	koji-Pq-mdd,-*-,koji-Pq-mdi,-*-,koji-Pq-ndd,-*-,koji-Pq-ndi,-*-,koji-Pq-fdd,-*-,koji-Pq-fdi
kojimi	koji-Pq-mpi,-*-,koji-Pq-npi,-*-,koji-Pq-fpi
kojo	koji-Pq-fsi,-*-,koji-Pq-fsa
kolik	kolik-Pq-msn,-*-,kolik-Pq-msa
kolika	kolik-Pq-mdn,-*-,kolik-Pq-mda,-*-,kolik-Pq-npn,-*-,kolik-Pq-npa,-*-,kolik-Pq-fsn
kolike	kolik-Pq-mpa,-*-,kolik-Pq-fsg,-*-,kolik-Pq-fpn,-*-,kolik-Pq-fpa
kolikega	kolik-Pq-msg,-*-,kolik-Pq-msa,-*-,kolik-Pq-nsg
kolikem	kolik-Pq-msl,-*-,kolik-Pq-nsl
kolikemu	kolik-Pq-msd,-*-,kolik-Pq-nsd
koliker	koliker-Pq-msn,-*-,koliker-Pq-msa
kolikera	koliker-Pq-mdn,-*-,koliker-Pq-mda,-*-,koliker-Pq-npn,-*-,koliker-Pq-npa,-*-,koliker-Pq-fsn
kolikere	koliker-Pq-mpa,-*-,koliker-Pq-fsg,-*-,koliker-Pq-fpn,-*-,koliker-Pq-fpa
kolikerega	koliker-Pq-msg,-*-,koliker-Pq-msa,-*-,koliker-Pq-nsg
kolikerem	koliker-Pq-msl,-*-,koliker-Pq-nsl
kolikeremu	koliker-Pq-msd,-*-,koliker-Pq-nsd
kolikeri	koliker-Pq-mpn,-*-,koliker-Pq-ndn,-*-,koliker-Pq-nda,-*-,koliker-Pq-fdn,-*-,koliker-Pq-fda,-*-,koliker-Pq-fsd,-*-,koliker-Pq-fsl
kolikerih	koliker-Pq-mdl,-*-,koliker-Pq-mdg,-*-,koliker-Pq-mpl,-*-,koliker-Pq-mpg,-*-,koliker-Pq-ndl,-*-,koliker-Pq-ndg,-*-,koliker-Pq-npl,-*-,koliker-Pq-npg,-*-,koliker-Pq-fdl,-*-,koliker-Pq-fdg,-*-,koliker-Pq-fpl,-*-,koliker-Pq-fpg
kolikerim	koliker-Pq-msi,-*-,koliker-Pq-mpd,-*-,koliker-Pq-nsi,-*-,koliker-Pq-npd,-*-,koliker-Pq-fpd
kolikerima	koliker-Pq-mdd,-*-,koliker-Pq-mdi,-*-,koliker-Pq-ndd,-*-,koliker-Pq-ndi,-*-,koliker-Pq-fdd,-*-,koliker-Pq-fdi
kolikerimi	koliker-Pq-mpi,-*-,koliker-Pq-npi,-*-,koliker-Pq-fpi
kolikero	koliker-Pq-nsn,-*-,koliker-Pq-nsa,-*-,koliker-Pq-fsi,-*-,koliker-Pq-fsa
koliki	kolik-Pq-mpn,-*-,kolik-Pq-ndn,-*-,kolik-Pq-nda,-*-,kolik-Pq-fdn,-*-,kolik-Pq-fda,-*-,kolik-Pq-fsd,-*-,kolik-Pq-fsl
kolikih	kolik-Pq-mdl,-*-,kolik-Pq-mdg,-*-,kolik-Pq-mpl,-*-,kolik-Pq-mpg,-*-,kolik-Pq-ndl,-*-,kolik-Pq-ndg,-*-,kolik-Pq-npl,-*-,kolik-Pq-npg,-*-,kolik-Pq-fdl,-*-,kolik-Pq-fdg,-*-,kolik-Pq-fpl,-*-,kolik-Pq-fpg
kolikim	kolik-Pq-msi,-*-,kolik-Pq-mpd,-*-,kolik-Pq-nsi,-*-,kolik-Pq-npd,-*-,kolik-Pq-fpd
kolikima	kolik-Pq-mdd,-*-,kolik-Pq-mdi,-*-,kolik-Pq-ndd,-*-,kolik-Pq-ndi,-*-,kolik-Pq-fdd,-*-,kolik-Pq-fdi
kolikimi	kolik-Pq-mpi,-*-,kolik-Pq-npi,-*-,kolik-Pq-fpi
koliko	kolik-Pq-nsn,-*-,kolik-Pq-nsa,-*-,kolik-Pq-fsi,-*-,kolik-Pq-fsa
kolikršen	kolikršen-Pr-msn,-*-,kolikršen-Pr-msa
kolikršna	kolikršen-Pr-mdn,-*-,kolikršen-Pr-mda,-*-,kolikršen-Pr-npn,-*-,kolikršen-Pr-npa,-*-,kolikršen-Pr-fsn
kolikršne	kolikršen-Pr-mpa,-*-,kolikršen-Pr-fsg,-*-,kolikršen-Pr-fpn,-*-,kolikršen-Pr-fpa
kolikršnega	kolikršen-Pr-msg,-*-,kolikršen-Pr-msa,-*-,kolikršen-Pr-nsg
kolikršnem	kolikršen-Pr-msl,-*-,kolikršen-Pr-nsl
kolikršnemu	kolikršen-Pr-msd,-*-,kolikršen-Pr-nsd
kolikršni	kolikršen-Pr-mpn,-*-,kolikršen-Pr-ndn,-*-,kolikršen-Pr-nda,-*-,kolikršen-Pr-fdn,-*-,kolikršen-Pr-fda,-*-,kolikršen-Pr-fsd,-*-,kolikršen-Pr-fsl
kolikršnih	kolikršen-Pr-mdl,-*-,kolikršen-Pr-mdg,-*-,kolikršen-Pr-mpl,-*-,kolikršen-Pr-mpg,-*-,kolikršen-Pr-ndl,-*-,kolikršen-Pr-ndg,-*-,kolikršen-Pr-npl,-*-,kolikršen-Pr-npg,-*-,kolikršen-Pr-fdl,-*-,kolikršen-Pr-fdg,-*-,kolikršen-Pr-fpl,-*-,kolikršen-Pr-fpg
kolikršnim	kolikršen-Pr-msi,-*-,kolikršen-Pr-mpd,-*-,kolikršen-Pr-nsi,-*-,kolikršen-Pr-npd,-*-,kolikršen-Pr-fpd
kolikršnima	kolikršen-Pr-mdd,-*-,kolikršen-Pr-mdi,-*-,kolikršen-Pr-ndd,-*-,kolikršen-Pr-ndi,-*-,kolikršen-Pr-fdd,-*-,kolikršen-Pr-fdi
kolikršnimi	kolikršen-Pr-mpi,-*-,kolikršen-Pr-npi,-*-,kolikršen-Pr-fpi
kolikršno	kolikršen-Pr-nsn,-*-,kolikršen-Pr-nsa,-*-,kolikršen-Pr-fsi,-*-,kolikršen-Pr-fsa
kolikšen	kolikšen-Pq-msn,-*-,kolikšen-Pq-msa
kolikšna	kolikšen-Pq-mdn,-*-,kolikšen-Pq-mda,-*-,kolikšen-Pq-npn,-*-,kolikšen-Pq-npa,-*-,kolikšen-Pq-fsn
kolikšne	kolikšen-Pq-mpa,-*-,kolikšen-Pq-fsg,-*-,kolikšen-Pq-fpn,-*-,kolikšen-Pq-fpa
kolikšnega	kolikšen-Pq-msg,-*-,kolikšen-Pq-msa,-*-,kolikšen-Pq-nsg
kolikšnem	kolikšen-Pq-msl,-*-,kolikšen-Pq-nsl
kolikšnemu	kolikšen-Pq-msd,-*-,kolikšen-Pq-nsd
kolikšni	kolikšen-Pq-mpn,-*-,kolikšen-Pq-ndn,-*-,kolikšen-Pq-nda,-*-,kolikšen-Pq-fdn,-*-,kolikšen-Pq-fda,-*-,kolikšen-Pq-fsd,-*-,kolikšen-Pq-fsl
kolikšnih	kolikšen-Pq-mdl,-*-,kolikšen-Pq-mdg,-*-,kolikšen-Pq-mpl,-*-,kolikšen-Pq-mpg,-*-,kolikšen-Pq-ndl,-*-,kolikšen-Pq-ndg,-*-,kolikšen-Pq-npl,-*-,kolikšen-Pq-npg,-*-,kolikšen-Pq-fdl,-*-,kolikšen-Pq-fdg,-*-,kolikšen-Pq-fpl,-*-,kolikšen-Pq-fpg
kolikšnim	kolikšen-Pq-msi,-*-,kolikšen-Pq-mpd,-*-,kolikšen-Pq-nsi,-*-,kolikšen-Pq-npd,-*-,kolikšen-Pq-fpd
kolikšnima	kolikšen-Pq-mdd,-*-,kolikšen-Pq-mdi,-*-,kolikšen-Pq-ndd,-*-,kolikšen-Pq-ndi,-*-,kolikšen-Pq-fdd,-*-,kolikšen-Pq-fdi
kolikšnimi	kolikšen-Pq-mpi,-*-,kolikšen-Pq-npi,-*-,kolikšen-Pq-fpi
kolikšno	kolikšen-Pq-nsn,-*-,kolikšen-Pq-nsa,-*-,kolikšen-Pq-fsi,-*-,kolikšen-Pq-fsa
kom	kdo-Pq-msl,-*-,kdo-Pq-msi
komer	kdor-Pr-msl,-*-,kdor-Pr-msi
komerkoli	kdorkoli-Pr-msl,-*-,kdorkoli-Pr-msi
komersibodi	kdorsibodi-Pr-msl,-*-,kdorsibodi-Pr-msi
komersižebodi	kdorsižebodi-Pr-msl,-*-,kdorsižebodi-Pr-msi
komu	kdo-Pq-msd
komur	kdor-Pr-msd
komurkoli	kdorkoli-Pr-msd
komursibodi	kdorsibodi-Pr-msd
komursižebodi	kdorsižebodi-Pr-msd
malokaj	malokaj-Pi-nsn,-*-,malokaj-Pi-nsa
malokak	malokak-Pi-msn,-*-,malokak-Pi-msa
malokaka	malokak-Pi-mdn,-*-,malokak-Pi-mda,-*-,malokak-Pi-npn,-*-,malokak-Pi-npa,-*-,malokak-Pi-fsn
malokake	malokak-Pi-mpa,-*-,malokak-Pi-fsg,-*-,malokak-Pi-fpn,-*-,malokak-Pi-fpa
malokakega	malokak-Pi-msg,-*-,malokak-Pi-msa,-*-,malokak-Pi-nsg
malokakem	malokak-Pi-msl,-*-,malokak-Pi-nsl
malokakemu	malokak-Pi-msd,-*-,malokak-Pi-nsd
malokaki	malokak-Pi-mpn,-*-,malokak-Pi-ndn,-*-,malokak-Pi-nda,-*-,malokak-Pi-fdn,-*-,malokak-Pi-fda,-*-,malokak-Pi-fsd,-*-,malokak-Pi-fsl
malokakih	malokak-Pi-mdl,-*-,malokak-Pi-mdg,-*-,malokak-Pi-mpl,-*-,malokak-Pi-mpg,-*-,malokak-Pi-ndl,-*-,malokak-Pi-ndg,-*-,malokak-Pi-npl,-*-,malokak-Pi-npg,-*-,malokak-Pi-fdl,-*-,malokak-Pi-fdg,-*-,malokak-Pi-fpl,-*-,malokak-Pi-fpg
malokakim	malokak-Pi-msi,-*-,malokak-Pi-mpd,-*-,malokak-Pi-nsi,-*-,malokak-Pi-npd,-*-,malokak-Pi-fpd
malokakima	malokak-Pi-mdd,-*-,malokak-Pi-mdi,-*-,malokak-Pi-ndd,-*-,malokak-Pi-ndi,-*-,malokak-Pi-fdd,-*-,malokak-Pi-fdi
malokakimi	malokak-Pi-mpi,-*-,malokak-Pi-npi,-*-,malokak-Pi-fpi
malokako	malokak-Pi-nsn,-*-,malokak-Pi-nsa,-*-,malokak-Pi-fsi,-*-,malokak-Pi-fsa
malokakšen	malokakšen-Pi-msn,-*-,malokakšen-Pi-msa
malokakšna	malokakšen-Pi-mdn,-*-,malokakšen-Pi-mda,-*-,malokakšen-Pi-npn,-*-,malokakšen-Pi-npa,-*-,malokakšen-Pi-fsn
malokakšne	malokakšen-Pi-mpa,-*-,malokakšen-Pi-fsg,-*-,malokakšen-Pi-fpn,-*-,malokakšen-Pi-fpa
malokakšnega	malokakšen-Pi-msg,-*-,malokakšen-Pi-msa,-*-,malokakšen-Pi-nsg
malokakšnem	malokakšen-Pi-msl,-*-,malokakšen-Pi-nsl
malokakšnemu	malokakšen-Pi-msd,-*-,malokakšen-Pi-nsd
malokakšni	malokakšen-Pi-mpn,-*-,malokakšen-Pi-ndn,-*-,malokakšen-Pi-nda,-*-,malokakšen-Pi-fdn,-*-,malokakšen-Pi-fda,-*-,malokakšen-Pi-fsd,-*-,malokakšen-Pi-fsl
malokakšnih	malokakšen-Pi-mdl,-*-,malokakšen-Pi-mdg,-*-,malokakšen-Pi-mpl,-*-,malokakšen-Pi-mpg,-*-,malokakšen-Pi-ndl,-*-,malokakšen-Pi-ndg,-*-,malokakšen-Pi-npl,-*-,malokakšen-Pi-npg,-*-,malokakšen-Pi-fdl,-*-,malokakšen-Pi-fdg,-*-,malokakšen-Pi-fpl,-*-,malokakšen-Pi-fpg
malokakšnim	malokakšen-Pi-msi,-*-,malokakšen-Pi-mpd,-*-,malokakšen-Pi-nsi,-*-,malokakšen-Pi-npd,-*-,malokakšen-Pi-fpd
malokakšnima	malokakšen-Pi-mdd,-*-,malokakšen-Pi-mdi,-*-,malokakšen-Pi-ndd,-*-,malokakšen-Pi-ndi,-*-,malokakšen-Pi-fdd,-*-,malokakšen-Pi-fdi
malokakšnimi	malokakšen-Pi-mpi,-*-,malokakšen-Pi-npi,-*-,malokakšen-Pi-fpi
malokakšno	malokakšen-Pi-nsn,-*-,malokakšen-Pi-nsa,-*-,malokakšen-Pi-fsi,-*-,malokakšen-Pi-fsa
malokatera	malokateri-Pi-mdn,-*-,malokateri-Pi-mda,-*-,malokateri-Pi-npn,-*-,malokateri-Pi-npa,-*-,malokateri-Pi-fsn
malokatere	malokateri-Pi-mpa,-*-,malokateri-Pi-fsg,-*-,malokateri-Pi-fpn,-*-,malokateri-Pi-fpa
malokaterega	malokateri-Pi-msg,-*-,malokateri-Pi-msa,-*-,malokateri-Pi-nsg
malokaterem	malokateri-Pi-msl,-*-,malokateri-Pi-nsl
malokateremu	malokateri-Pi-msd,-*-,malokateri-Pi-nsd
malokateri	malokateri-Pi-msn,-*-,malokateri-Pi-msa,-*-,malokateri-Pi-mpn,-*-,malokateri-Pi-ndn,-*-,malokateri-Pi-nda,-*-,malokateri-Pi-fdn,-*-,malokateri-Pi-fda,-*-,malokateri-Pi-fsd,-*-,malokateri-Pi-fsl
malokaterih	malokateri-Pi-mdl,-*-,malokateri-Pi-mdg,-*-,malokateri-Pi-mpl,-*-,malokateri-Pi-mpg,-*-,malokateri-Pi-ndl,-*-,malokateri-Pi-ndg,-*-,malokateri-Pi-npl,-*-,malokateri-Pi-npg,-*-,malokateri-Pi-fdl,-*-,malokateri-Pi-fdg,-*-,malokateri-Pi-fpl,-*-,malokateri-Pi-fpg
malokaterim	malokateri-Pi-msi,-*-,malokateri-Pi-mpd,-*-,malokateri-Pi-nsi,-*-,malokateri-Pi-npd,-*-,malokateri-Pi-fpd
malokaterima	malokateri-Pi-mdd,-*-,malokateri-Pi-mdi,-*-,malokateri-Pi-ndd,-*-,malokateri-Pi-ndi,-*-,malokateri-Pi-fdd,-*-,malokateri-Pi-fdi
malokaterimi	malokateri-Pi-mpi,-*-,malokateri-Pi-npi,-*-,malokateri-Pi-fpi
malokatero	malokateri-Pi-nsn,-*-,malokateri-Pi-nsa,-*-,malokateri-Pi-fsi,-*-,malokateri-Pi-fsa
malokdo	malokdo-Pi-msn
malokoga	malokdo-Pi-msg,-*-,malokdo-Pi-msa
malokom	malokdo-Pi-msl,-*-,malokdo-Pi-msi
malokomu	malokdo-Pi-msd
maločem	malokaj-Pi-nsl
maločemu	malokaj-Pi-nsd
maločesa	malokaj-Pi-nsg
maločim	malokaj-Pi-nsi
mano	jaz-Pp1-si
marsikaj	marsikaj-Pi-nsn,-*-,marsikaj-Pi-nsa
marsikak	marsikak-Pi-msn,-*-,marsikak-Pi-msa
marsikaka	marsikak-Pi-mdn,-*-,marsikak-Pi-mda,-*-,marsikak-Pi-npn,-*-,marsikak-Pi-npa,-*-,marsikak-Pi-fsn
marsikake	marsikak-Pi-mpa,-*-,marsikak-Pi-fsg,-*-,marsikak-Pi-fpn,-*-,marsikak-Pi-fpa
marsikakega	marsikak-Pi-msg,-*-,marsikak-Pi-msa,-*-,marsikak-Pi-nsg
marsikakem	marsikak-Pi-msl,-*-,marsikak-Pi-nsl
marsikakemu	marsikak-Pi-msd,-*-,marsikak-Pi-nsd
marsikaki	marsikak-Pi-mpn,-*-,marsikak-Pi-ndn,-*-,marsikak-Pi-nda,-*-,marsikak-Pi-fdn,-*-,marsikak-Pi-fda,-*-,marsikak-Pi-fsd,-*-,marsikak-Pi-fsl
marsikakih	marsikak-Pi-mdl,-*-,marsikak-Pi-mdg,-*-,marsikak-Pi-mpl,-*-,marsikak-Pi-mpg,-*-,marsikak-Pi-ndl,-*-,marsikak-Pi-ndg,-*-,marsikak-Pi-npl,-*-,marsikak-Pi-npg,-*-,marsikak-Pi-fdl,-*-,marsikak-Pi-fdg,-*-,marsikak-Pi-fpl,-*-,marsikak-Pi-fpg
marsikakim	marsikak-Pi-msi,-*-,marsikak-Pi-mpd,-*-,marsikak-Pi-nsi,-*-,marsikak-Pi-npd,-*-,marsikak-Pi-fpd
marsikakima	marsikak-Pi-mdd,-*-,marsikak-Pi-mdi,-*-,marsikak-Pi-ndd,-*-,marsikak-Pi-ndi,-*-,marsikak-Pi-fdd,-*-,marsikak-Pi-fdi
marsikakimi	marsikak-Pi-mpi,-*-,marsikak-Pi-npi,-*-,marsikak-Pi-fpi
marsikako	marsikak-Pi-nsn,-*-,marsikak-Pi-nsa,-*-,marsikak-Pi-fsi,-*-,marsikak-Pi-fsa
marsikakšen	marsikakšen-Pi-msn,-*-,marsikakšen-Pi-msa
marsikakšna	marsikakšen-Pi-mdn,-*-,marsikakšen-Pi-mda,-*-,marsikakšen-Pi-npn,-*-,marsikakšen-Pi-npa,-*-,marsikakšen-Pi-fsn
marsikakšne	marsikakšen-Pi-mpa,-*-,marsikakšen-Pi-fsg,-*-,marsikakšen-Pi-fpn,-*-,marsikakšen-Pi-fpa
marsikakšnega	marsikakšen-Pi-msg,-*-,marsikakšen-Pi-msa,-*-,marsikakšen-Pi-nsg
marsikakšnem	marsikakšen-Pi-msl,-*-,marsikakšen-Pi-nsl
marsikakšnemu	marsikakšen-Pi-msd,-*-,marsikakšen-Pi-nsd
marsikakšni	marsikakšen-Pi-mpn,-*-,marsikakšen-Pi-ndn,-*-,marsikakšen-Pi-nda,-*-,marsikakšen-Pi-fdn,-*-,marsikakšen-Pi-fda,-*-,marsikakšen-Pi-fsd,-*-,marsikakšen-Pi-fsl
marsikakšnih	marsikakšen-Pi-mdl,-*-,marsikakšen-Pi-mdg,-*-,marsikakšen-Pi-mpl,-*-,marsikakšen-Pi-mpg,-*-,marsikakšen-Pi-ndl,-*-,marsikakšen-Pi-ndg,-*-,marsikakšen-Pi-npl,-*-,marsikakšen-Pi-npg,-*-,marsikakšen-Pi-fdl,-*-,marsikakšen-Pi-fdg,-*-,marsikakšen-Pi-fpl,-*-,marsikakšen-Pi-fpg
marsikakšnim	marsikakšen-Pi-msi,-*-,marsikakšen-Pi-mpd,-*-,marsikakšen-Pi-nsi,-*-,marsikakšen-Pi-npd,-*-,marsikakšen-Pi-fpd
marsikakšnima	marsikakšen-Pi-mdd,-*-,marsikakšen-Pi-mdi,-*-,marsikakšen-Pi-ndd,-*-,marsikakšen-Pi-ndi,-*-,marsikakšen-Pi-fdd,-*-,marsikakšen-Pi-fdi
marsikakšnimi	marsikakšen-Pi-mpi,-*-,marsikakšen-Pi-npi,-*-,marsikakšen-Pi-fpi
marsikakšno	marsikakšen-Pi-nsn,-*-,marsikakšen-Pi-nsa,-*-,marsikakšen-Pi-fsi,-*-,marsikakšen-Pi-fsa
marsikatera	marsikateri-Pi-mdn,-*-,marsikateri-Pi-mda,-*-,marsikateri-Pi-npn,-*-,marsikateri-Pi-npa,-*-,marsikateri-Pi-fsn
marsikatere	marsikateri-Pi-mpa,-*-,marsikateri-Pi-fsg,-*-,marsikateri-Pi-fpn,-*-,marsikateri-Pi-fpa
marsikaterega	marsikateri-Pi-msg,-*-,marsikateri-Pi-msa,-*-,marsikateri-Pi-nsg
marsikaterem	marsikateri-Pi-msl,-*-,marsikateri-Pi-nsl
marsikateremu	marsikateri-Pi-msd,-*-,marsikateri-Pi-nsd
marsikateri	marsikateri-Pi-msn,-*-,marsikateri-Pi-msa,-*-,marsikateri-Pi-mpn,-*-,marsikateri-Pi-ndn,-*-,marsikateri-Pi-nda,-*-,marsikateri-Pi-fdn,-*-,marsikateri-Pi-fda,-*-,marsikateri-Pi-fsd,-*-,marsikateri-Pi-fsl
marsikaterih	marsikateri-Pi-mdl,-*-,marsikateri-Pi-mdg,-*-,marsikateri-Pi-mpl,-*-,marsikateri-Pi-mpg,-*-,marsikateri-Pi-ndl,-*-,marsikateri-Pi-ndg,-*-,marsikateri-Pi-npl,-*-,marsikateri-Pi-npg,-*-,marsikateri-Pi-fdl,-*-,marsikateri-Pi-fdg,-*-,marsikateri-Pi-fpl,-*-,marsikateri-Pi-fpg
marsikaterim	marsikateri-Pi-msi,-*-,marsikateri-Pi-mpd,-*-,marsikateri-Pi-nsi,-*-,marsikateri-Pi-npd,-*-,marsikateri-Pi-fpd
marsikaterima	marsikateri-Pi-mdd,-*-,marsikateri-Pi-mdi,-*-,marsikateri-Pi-ndd,-*-,marsikateri-Pi-ndi,-*-,marsikateri-Pi-fdd,-*-,marsikateri-Pi-fdi
marsikaterimi	marsikateri-Pi-mpi,-*-,marsikateri-Pi-npi,-*-,marsikateri-Pi-fpi
marsikatero	marsikateri-Pi-nsn,-*-,marsikateri-Pi-nsa,-*-,marsikateri-Pi-fsi,-*-,marsikateri-Pi-fsa
marsikdo	marsikdo-Pi-msn
marsikoga	marsikdo-Pi-msg,-*-,marsikdo-Pi-msa
marsikom	marsikdo-Pi-msl,-*-,marsikdo-Pi-msi
marsikomu	marsikdo-Pi-msd
marsičem	marsikaj-Pi-nsl
marsičemu	marsikaj-Pi-nsd
marsičesa	marsikaj-Pi-nsg
marsičigav	marsičigav-Pi-msn,-*-,marsičigav-Pi-msa
marsičigava	marsičigav-Pi-mdn,-*-,marsičigav-Pi-mda,-*-,marsičigav-Pi-npn,-*-,marsičigav-Pi-npa,-*-,marsičigav-Pi-fsn
marsičigave	marsičigav-Pi-mpa,-*-,marsičigav-Pi-fsg,-*-,marsičigav-Pi-fpn,-*-,marsičigav-Pi-fpa
marsičigavega	marsičigav-Pi-msg,-*-,marsičigav-Pi-msa,-*-,marsičigav-Pi-nsg
marsičigavem	marsičigav-Pi-msl,-*-,marsičigav-Pi-nsl
marsičigavemu	marsičigav-Pi-msd,-*-,marsičigav-Pi-nsd
marsičigavi	marsičigav-Pi-mpn,-*-,marsičigav-Pi-ndn,-*-,marsičigav-Pi-nda,-*-,marsičigav-Pi-fdn,-*-,marsičigav-Pi-fda,-*-,marsičigav-Pi-fsd,-*-,marsičigav-Pi-fsl
marsičigavih	marsičigav-Pi-mdl,-*-,marsičigav-Pi-mdg,-*-,marsičigav-Pi-mpl,-*-,marsičigav-Pi-mpg,-*-,marsičigav-Pi-ndl,-*-,marsičigav-Pi-ndg,-*-,marsičigav-Pi-npl,-*-,marsičigav-Pi-npg,-*-,marsičigav-Pi-fdl,-*-,marsičigav-Pi-fdg,-*-,marsičigav-Pi-fpl,-*-,marsičigav-Pi-fpg
marsičigavim	marsičigav-Pi-msi,-*-,marsičigav-Pi-mpd,-*-,marsičigav-Pi-nsi,-*-,marsičigav-Pi-npd,-*-,marsičigav-Pi-fpd
marsičigavima	marsičigav-Pi-mdd,-*-,marsičigav-Pi-mdi,-*-,marsičigav-Pi-ndd,-*-,marsičigav-Pi-ndi,-*-,marsičigav-Pi-fdd,-*-,marsičigav-Pi-fdi
marsičigavimi	marsičigav-Pi-mpi,-*-,marsičigav-Pi-npi,-*-,marsičigav-Pi-fpi
marsičigavo	marsičigav-Pi-nsn,-*-,marsičigav-Pi-nsa,-*-,marsičigav-Pi-fsi,-*-,marsičigav-Pi-fsa
marsičim	marsikaj-Pi-nsi
me	jaz-Pp1-sg--y,-*-,jaz-Pp1-sa--y,-*-,jaz-Pp1fpn
medenj	medme-Pp3msa--b,-*-,medme-Pp3nsa--b
medme	medme-Pp1-sa--b
mednje	medme-Pp3mpa--b,-*-,medme-Pp3npa--b,-*-,medme-Pp3fpa--b
mednjo	medme-Pp3fsa--b
mednju	medme-Pp3mda--b,-*-,medme-Pp3nda--b,-*-,medme-Pp3fda--b
medse	medse-Px---a--b
medte	medme-Pp2-sa--b
medve	jaz-Pp1fdn
mene	jaz-Pp1-sg,-*-,jaz-Pp1-sa
meni	jaz-Pp1-sd,-*-,jaz-Pp1-sl
menoj	jaz-Pp1-si
mi	jaz-Pp1-sd--y,-*-,jaz-Pp1mpn
midva	jaz-Pp1mdn
midve	jaz-Pp1fdn
mnog	mnog-Pi-msn,-*-,mnog-Pi-msa
mnoga	mnog-Pi-mdn,-*-,mnog-Pi-mda,-*-,mnog-Pi-npn,-*-,mnog-Pi-npa,-*-,mnog-Pi-fsn
mnoge	mnog-Pi-mpa,-*-,mnog-Pi-fsg,-*-,mnog-Pi-fpn,-*-,mnog-Pi-fpa
mnogega	mnog-Pi-msg,-*-,mnog-Pi-msa,-*-,mnog-Pi-nsg
mnogem	mnog-Pi-msl,-*-,mnog-Pi-nsl
mnogemu	mnog-Pi-msd,-*-,mnog-Pi-nsd
mnogi	mnog-Pi-msn,-*-,mnog-Pi-msa,-*-,mnog-Pi-mpn,-*-,mnog-Pi-ndn,-*-,mnog-Pi-nda,-*-,mnog-Pi-fdn,-*-,mnog-Pi-fda,-*-,mnog-Pi-fsd,-*-,mnog-Pi-fsl
mnogih	mnog-Pi-mdl,-*-,mnog-Pi-mdg,-*-,mnog-Pi-mpl,-*-,mnog-Pi-mpg,-*-,mnog-Pi-ndl,-*-,mnog-Pi-ndg,-*-,mnog-Pi-npl,-*-,mnog-Pi-npg,-*-,mnog-Pi-fdl,-*-,mnog-Pi-fdg,-*-,mnog-Pi-fpl,-*-,mnog-Pi-fpg
mnogim	mnog-Pi-msi,-*-,mnog-Pi-mpd,-*-,mnog-Pi-nsi,-*-,mnog-Pi-npd,-*-,mnog-Pi-fpd
mnogima	mnog-Pi-mdd,-*-,mnog-Pi-mdi,-*-,mnog-Pi-ndd,-*-,mnog-Pi-ndi,-*-,mnog-Pi-fdd,-*-,mnog-Pi-fdi
mnogimi	mnog-Pi-mpi,-*-,mnog-Pi-npi,-*-,mnog-Pi-fpi
mnogo	mnog-Pi-nsn,-*-,mnog-Pi-nsa,-*-,mnog-Pi-fsi,-*-,mnog-Pi-fsa
mnogokaj	mnogokaj-Pi-nsn,-*-,mnogokaj-Pi-nsa
mnogokatera	mnogokateri-Pi-mdn,-*-,mnogokateri-Pi-mda,-*-,mnogokateri-Pi-npn,-*-,mnogokateri-Pi-npa,-*-,mnogokateri-Pi-fsn
mnogokatere	mnogokateri-Pi-mpa,-*-,mnogokateri-Pi-fsg,-*-,mnogokateri-Pi-fpn,-*-,mnogokateri-Pi-fpa
mnogokaterega	mnogokateri-Pi-msg,-*-,mnogokateri-Pi-msa,-*-,mnogokateri-Pi-nsg
mnogokaterem	mnogokateri-Pi-msl,-*-,mnogokateri-Pi-nsl
mnogokateremu	mnogokateri-Pi-msd,-*-,mnogokateri-Pi-nsd
mnogokateri	mnogokateri-Pi-msn,-*-,mnogokateri-Pi-msa,-*-,mnogokateri-Pi-mpn,-*-,mnogokateri-Pi-ndn,-*-,mnogokateri-Pi-nda,-*-,mnogokateri-Pi-fdn,-*-,mnogokateri-Pi-fda,-*-,mnogokateri-Pi-fsd,-*-,mnogokateri-Pi-fsl
mnogokaterih	mnogokateri-Pi-mdl,-*-,mnogokateri-Pi-mdg,-*-,mnogokateri-Pi-mpl,-*-,mnogokateri-Pi-mpg,-*-,mnogokateri-Pi-ndl,-*-,mnogokateri-Pi-ndg,-*-,mnogokateri-Pi-npl,-*-,mnogokateri-Pi-npg,-*-,mnogokateri-Pi-fdl,-*-,mnogokateri-Pi-fdg,-*-,mnogokateri-Pi-fpl,-*-,mnogokateri-Pi-fpg
mnogokaterim	mnogokateri-Pi-msi,-*-,mnogokateri-Pi-mpd,-*-,mnogokateri-Pi-nsi,-*-,mnogokateri-Pi-npd,-*-,mnogokateri-Pi-fpd
mnogokaterima	mnogokateri-Pi-mdd,-*-,mnogokateri-Pi-mdi,-*-,mnogokateri-Pi-ndd,-*-,mnogokateri-Pi-ndi,-*-,mnogokateri-Pi-fdd,-*-,mnogokateri-Pi-fdi
mnogokaterimi	mnogokateri-Pi-mpi,-*-,mnogokateri-Pi-npi,-*-,mnogokateri-Pi-fpi
mnogokatero	mnogokateri-Pi-nsn,-*-,mnogokateri-Pi-nsa,-*-,mnogokateri-Pi-fsi,-*-,mnogokateri-Pi-fsa
mnogokdo	mnogokdo-Pi-msn
mnogokoga	mnogokdo-Pi-msg,-*-,mnogokdo-Pi-msa
mnogokom	mnogokdo-Pi-msl,-*-,mnogokdo-Pi-msi
mnogokomu	mnogokdo-Pi-msd
mnogočem	mnogokaj-Pi-nsl
mnogočemu	mnogokaj-Pi-nsd
mnogočesa	mnogokaj-Pi-nsg
mnogočim	mnogokaj-Pi-nsi
moj	moj-Ps1msns,-*-,moj-Ps1msas
moja	moj-Ps1mdns,-*-,moj-Ps1mdas,-*-,moj-Ps1npns,-*-,moj-Ps1npas,-*-,moj-Ps1fsns
moje	moj-Ps1mpas,-*-,moj-Ps1nsns,-*-,moj-Ps1nsas,-*-,moj-Ps1fsgs,-*-,moj-Ps1fpns,-*-,moj-Ps1fpas
mojega	moj-Ps1msgs,-*-,moj-Ps1msas,-*-,moj-Ps1nsgs
mojem	moj-Ps1msls,-*-,moj-Ps1nsls
mojemu	moj-Ps1msds,-*-,moj-Ps1nsds
moji	moj-Ps1mpns,-*-,moj-Ps1ndns,-*-,moj-Ps1ndas,-*-,moj-Ps1fdns,-*-,moj-Ps1fdas,-*-,moj-Ps1fsds,-*-,moj-Ps1fsls
mojih	moj-Ps1mdls,-*-,moj-Ps1mdgs,-*-,moj-Ps1mpls,-*-,moj-Ps1mpgs,-*-,moj-Ps1ndls,-*-,moj-Ps1ndgs,-*-,moj-Ps1npls,-*-,moj-Ps1npgs,-*-,moj-Ps1fdls,-*-,moj-Ps1fdgs,-*-,moj-Ps1fpls,-*-,moj-Ps1fpgs
mojim	moj-Ps1msis,-*-,moj-Ps1mpds,-*-,moj-Ps1nsis,-*-,moj-Ps1npds,-*-,moj-Ps1fpds
mojima	moj-Ps1mdds,-*-,moj-Ps1mdis,-*-,moj-Ps1ndds,-*-,moj-Ps1ndis,-*-,moj-Ps1fdds,-*-,moj-Ps1fdis
mojimi	moj-Ps1mpis,-*-,moj-Ps1npis,-*-,moj-Ps1fpis
mojo	moj-Ps1fsis,-*-,moj-Ps1fsas
mu	on-Pp3msd--y,-*-,on-Pp3nsd--y
nadenj	nadme-Pp3msa--b,-*-,nadme-Pp3nsa--b
nadme	nadme-Pp1-sa--b
nadnje	nadme-Pp3mpa--b,-*-,nadme-Pp3npa--b,-*-,nadme-Pp3fpa--b
nadnjo	nadme-Pp3fsa--b
nadnju	nadme-Pp3mda--b,-*-,nadme-Pp3nda--b,-*-,nadme-Pp3fda--b
nadse	nadse-Px---a--b
nadte	nadme-Pp2-sa--b
najin	najin-Ps1msnd,-*-,najin-Ps1msad
najina	najin-Ps1mdnd,-*-,najin-Ps1mdad,-*-,najin-Ps1npnd,-*-,najin-Ps1npad,-*-,najin-Ps1fsnd
najine	najin-Ps1mpad,-*-,najin-Ps1fsgd,-*-,najin-Ps1fpnd,-*-,najin-Ps1fpad
najinega	najin-Ps1msgd,-*-,najin-Ps1msad,-*-,najin-Ps1nsgd
najinem	najin-Ps1msld,-*-,najin-Ps1nsld
najinemu	najin-Ps1msdd,-*-,najin-Ps1nsdd
najini	najin-Ps1mpnd,-*-,najin-Ps1ndnd,-*-,najin-Ps1ndad,-*-,najin-Ps1fdnd,-*-,najin-Ps1fdad,-*-,najin-Ps1fsdd,-*-,najin-Ps1fsld
najinih	najin-Ps1mdld,-*-,najin-Ps1mdgd,-*-,najin-Ps1mpld,-*-,najin-Ps1mpgd,-*-,najin-Ps1ndld,-*-,najin-Ps1ndgd,-*-,najin-Ps1npld,-*-,najin-Ps1npgd,-*-,najin-Ps1fdld,-*-,najin-Ps1fdgd,-*-,najin-Ps1fpld,-*-,najin-Ps1fpgd
najinim	najin-Ps1msid,-*-,najin-Ps1mpdd,-*-,najin-Ps1nsid,-*-,najin-Ps1npdd,-*-,najin-Ps1fpdd
najinima	najin-Ps1mddd,-*-,najin-Ps1mdid,-*-,najin-Ps1nddd,-*-,najin-Ps1ndid,-*-,najin-Ps1fddd,-*-,najin-Ps1fdid
najinimi	najin-Ps1mpid,-*-,najin-Ps1npid,-*-,najin-Ps1fpid
najino	najin-Ps1nsnd,-*-,najin-Ps1nsad,-*-,najin-Ps1fsid,-*-,najin-Ps1fsad
naju	jaz-Pp1-dl,-*-,jaz-Pp1-dg,-*-,jaz-Pp1-da
nam	jaz-Pp1-pd
nama	jaz-Pp1-dd,-*-,jaz-Pp1-dl,-*-,jaz-Pp1-di
name	name-Pp1-sa--b
nami	jaz-Pp1-pi
nanj	name-Pp3msa--b,-*-,name-Pp3nsa--b
nanje	name-Pp3mpa--b,-*-,name-Pp3npa--b,-*-,name-Pp3fpa--b
nanjo	name-Pp3fsa--b
nanju	name-Pp3mda--b,-*-,name-Pp3nda--b,-*-,name-Pp3fda--b
nas	jaz-Pp1-pl,-*-,jaz-Pp1-pg,-*-,jaz-Pp1-pa
nase	nase-Px---a--b
nate	name-Pp2-sa--b
naš	naš-Ps1msnp,-*-,naš-Ps1msap
naša	naš-Ps1mdnp,-*-,naš-Ps1mdap,-*-,naš-Ps1npnp,-*-,naš-Ps1npap,-*-,naš-Ps1fsnp
naše	naš-Ps1mpap,-*-,naš-Ps1nsnp,-*-,naš-Ps1nsap,-*-,naš-Ps1fsgp,-*-,naš-Ps1fpnp,-*-,naš-Ps1fpap
našega	naš-Ps1msgp,-*-,naš-Ps1msap,-*-,naš-Ps1nsgp
našem	naš-Ps1mslp,-*-,naš-Ps1nslp
našemu	naš-Ps1msdp,-*-,naš-Ps1nsdp
naši	naš-Ps1mpnp,-*-,naš-Ps1ndnp,-*-,naš-Ps1ndap,-*-,naš-Ps1fdnp,-*-,naš-Ps1fdap,-*-,naš-Ps1fsdp,-*-,naš-Ps1fslp
naših	naš-Ps1mdlp,-*-,naš-Ps1mdgp,-*-,naš-Ps1mplp,-*-,naš-Ps1mpgp,-*-,naš-Ps1ndlp,-*-,naš-Ps1ndgp,-*-,naš-Ps1nplp,-*-,naš-Ps1npgp,-*-,naš-Ps1fdlp,-*-,naš-Ps1fdgp,-*-,naš-Ps1fplp,-*-,naš-Ps1fpgp
našim	naš-Ps1msip,-*-,naš-Ps1mpdp,-*-,naš-Ps1nsip,-*-,naš-Ps1npdp,-*-,naš-Ps1fpdp
našima	naš-Ps1mddp,-*-,naš-Ps1mdip,-*-,naš-Ps1nddp,-*-,naš-Ps1ndip,-*-,naš-Ps1fddp,-*-,naš-Ps1fdip
našimi	naš-Ps1mpip,-*-,naš-Ps1npip,-*-,naš-Ps1fpip
našo	naš-Ps1fsip,-*-,naš-Ps1fsap
nek	nek-Pi-msn,-*-,nek-Pi-msa
neka	nek-Pi-mdn,-*-,nek-Pi-mda,-*-,nek-Pi-npn,-*-,nek-Pi-npa,-*-,nek-Pi-fsn
nekaj	nekaj-Pi-nsn,-*-,nekaj-Pi-nsa
nekak	nekak-Pi-msn,-*-,nekak-Pi-msa
nekaka	nekak-Pi-mdn,-*-,nekak-Pi-mda,-*-,nekak-Pi-npn,-*-,nekak-Pi-npa,-*-,nekak-Pi-fsn
nekake	nekak-Pi-mpa,-*-,nekak-Pi-fsg,-*-,nekak-Pi-fpn,-*-,nekak-Pi-fpa
nekakega	nekak-Pi-msg,-*-,nekak-Pi-msa,-*-,nekak-Pi-nsg
nekakem	nekak-Pi-msl,-*-,nekak-Pi-nsl
nekakemu	nekak-Pi-msd,-*-,nekak-Pi-nsd
nekaki	nekak-Pi-mpn,-*-,nekak-Pi-ndn,-*-,nekak-Pi-nda,-*-,nekak-Pi-fdn,-*-,nekak-Pi-fda,-*-,nekak-Pi-fsd,-*-,nekak-Pi-fsl
nekakih	nekak-Pi-mdl,-*-,nekak-Pi-mdg,-*-,nekak-Pi-mpl,-*-,nekak-Pi-mpg,-*-,nekak-Pi-ndl,-*-,nekak-Pi-ndg,-*-,nekak-Pi-npl,-*-,nekak-Pi-npg,-*-,nekak-Pi-fdl,-*-,nekak-Pi-fdg,-*-,nekak-Pi-fpl,-*-,nekak-Pi-fpg
nekakim	nekak-Pi-msi,-*-,nekak-Pi-mpd,-*-,nekak-Pi-nsi,-*-,nekak-Pi-npd,-*-,nekak-Pi-fpd
nekakima	nekak-Pi-mdd,-*-,nekak-Pi-mdi,-*-,nekak-Pi-ndd,-*-,nekak-Pi-ndi,-*-,nekak-Pi-fdd,-*-,nekak-Pi-fdi
nekakimi	nekak-Pi-mpi,-*-,nekak-Pi-npi,-*-,nekak-Pi-fpi
nekako	nekak-Pi-nsn,-*-,nekak-Pi-nsa,-*-,nekak-Pi-fsi,-*-,nekak-Pi-fsa
nekakov	nekakov-Pi-msn,-*-,nekakov-Pi-msa
nekakova	nekakov-Pi-mdn,-*-,nekakov-Pi-mda,-*-,nekakov-Pi-npn,-*-,nekakov-Pi-npa,-*-,nekakov-Pi-fsn
nekakove	nekakov-Pi-mpa,-*-,nekakov-Pi-fsg,-*-,nekakov-Pi-fpn,-*-,nekakov-Pi-fpa
nekakovega	nekakov-Pi-msg,-*-,nekakov-Pi-msa,-*-,nekakov-Pi-nsg
nekakovem	nekakov-Pi-msl,-*-,nekakov-Pi-nsl
nekakovemu	nekakov-Pi-msd,-*-,nekakov-Pi-nsd
nekakovi	nekakov-Pi-mpn,-*-,nekakov-Pi-ndn,-*-,nekakov-Pi-nda,-*-,nekakov-Pi-fdn,-*-,nekakov-Pi-fda,-*-,nekakov-Pi-fsd,-*-,nekakov-Pi-fsl
nekakovih	nekakov-Pi-mdl,-*-,nekakov-Pi-mdg,-*-,nekakov-Pi-mpl,-*-,nekakov-Pi-mpg,-*-,nekakov-Pi-ndl,-*-,nekakov-Pi-ndg,-*-,nekakov-Pi-npl,-*-,nekakov-Pi-npg,-*-,nekakov-Pi-fdl,-*-,nekakov-Pi-fdg,-*-,nekakov-Pi-fpl,-*-,nekakov-Pi-fpg
nekakovim	nekakov-Pi-msi,-*-,nekakov-Pi-mpd,-*-,nekakov-Pi-nsi,-*-,nekakov-Pi-npd,-*-,nekakov-Pi-fpd
nekakovima	nekakov-Pi-mdd,-*-,nekakov-Pi-mdi,-*-,nekakov-Pi-ndd,-*-,nekakov-Pi-ndi,-*-,nekakov-Pi-fdd,-*-,nekakov-Pi-fdi
nekakovimi	nekakov-Pi-mpi,-*-,nekakov-Pi-npi,-*-,nekakov-Pi-fpi
nekakovo	nekakov-Pi-nsn,-*-,nekakov-Pi-nsa,-*-,nekakov-Pi-fsi,-*-,nekakov-Pi-fsa
nekakšen	nekakšen-Pi-msn,-*-,nekakšen-Pi-msa
nekakšna	nekakšen-Pi-mdn,-*-,nekakšen-Pi-mda,-*-,nekakšen-Pi-npn,-*-,nekakšen-Pi-npa,-*-,nekakšen-Pi-fsn
nekakšne	nekakšen-Pi-mpa,-*-,nekakšen-Pi-fsg,-*-,nekakšen-Pi-fpn,-*-,nekakšen-Pi-fpa
nekakšnega	nekakšen-Pi-msg,-*-,nekakšen-Pi-msa,-*-,nekakšen-Pi-nsg
nekakšnem	nekakšen-Pi-msl,-*-,nekakšen-Pi-nsl
nekakšnemu	nekakšen-Pi-msd,-*-,nekakšen-Pi-nsd
nekakšni	nekakšen-Pi-mpn,-*-,nekakšen-Pi-ndn,-*-,nekakšen-Pi-nda,-*-,nekakšen-Pi-fdn,-*-,nekakšen-Pi-fda,-*-,nekakšen-Pi-fsd,-*-,nekakšen-Pi-fsl
nekakšnih	nekakšen-Pi-mdl,-*-,nekakšen-Pi-mdg,-*-,nekakšen-Pi-mpl,-*-,nekakšen-Pi-mpg,-*-,nekakšen-Pi-ndl,-*-,nekakšen-Pi-ndg,-*-,nekakšen-Pi-npl,-*-,nekakšen-Pi-npg,-*-,nekakšen-Pi-fdl,-*-,nekakšen-Pi-fdg,-*-,nekakšen-Pi-fpl,-*-,nekakšen-Pi-fpg
nekakšnim	nekakšen-Pi-msi,-*-,nekakšen-Pi-mpd,-*-,nekakšen-Pi-nsi,-*-,nekakšen-Pi-npd,-*-,nekakšen-Pi-fpd
nekakšnima	nekakšen-Pi-mdd,-*-,nekakšen-Pi-mdi,-*-,nekakšen-Pi-ndd,-*-,nekakšen-Pi-ndi,-*-,nekakšen-Pi-fdd,-*-,nekakšen-Pi-fdi
nekakšnimi	nekakšen-Pi-mpi,-*-,nekakšen-Pi-npi,-*-,nekakšen-Pi-fpi
nekakšno	nekakšen-Pi-nsn,-*-,nekakšen-Pi-nsa,-*-,nekakšen-Pi-fsi,-*-,nekakšen-Pi-fsa
nekatera	nekateri-Pi-npn,-*-,nekateri-Pi-npa
nekatere	nekateri-Pi-mpa,-*-,nekateri-Pi-fpn,-*-,nekateri-Pi-fpa
nekateri	nekateri-Pi-mpn
nekaterih	nekateri-Pi-mpl,-*-,nekateri-Pi-mpg,-*-,nekateri-Pi-npl,-*-,nekateri-Pi-npg,-*-,nekateri-Pi-fpl,-*-,nekateri-Pi-fpg
nekaterim	nekateri-Pi-mpd,-*-,nekateri-Pi-npd,-*-,nekateri-Pi-fpd
nekaterimi	nekateri-Pi-mpi,-*-,nekateri-Pi-npi,-*-,nekateri-Pi-fpi
nekdo	nekdo-Pi-msn
neke	nek-Pi-mpa,-*-,nek-Pi-fsg,-*-,nek-Pi-fpn,-*-,nek-Pi-fpa
nekega	nek-Pi-msg,-*-,nek-Pi-msa,-*-,nek-Pi-nsg
nekem	nek-Pi-msl,-*-,nek-Pi-nsl
nekemu	nek-Pi-msd,-*-,nek-Pi-nsd
neki	nek-Pi-mpn,-*-,nek-Pi-ndn,-*-,nek-Pi-nda,-*-,nek-Pi-fdn,-*-,nek-Pi-fda,-*-,nek-Pi-fsd,-*-,nek-Pi-fsl,-*-,neki-Pi-msn
nekih	nek-Pi-mdl,-*-,nek-Pi-mdg,-*-,nek-Pi-mpl,-*-,nek-Pi-mpg,-*-,nek-Pi-ndl,-*-,nek-Pi-ndg,-*-,nek-Pi-npl,-*-,nek-Pi-npg,-*-,nek-Pi-fdl,-*-,nek-Pi-fdg,-*-,nek-Pi-fpl,-*-,nek-Pi-fpg
nekim	nek-Pi-msi,-*-,nek-Pi-mpd,-*-,nek-Pi-nsi,-*-,nek-Pi-npd,-*-,nek-Pi-fpd
nekima	nek-Pi-mdd,-*-,nek-Pi-mdi,-*-,nek-Pi-ndd,-*-,nek-Pi-ndi,-*-,nek-Pi-fdd,-*-,nek-Pi-fdi
nekimi	nek-Pi-mpi,-*-,nek-Pi-npi,-*-,nek-Pi-fpi
neko	nek-Pi-nsn,-*-,nek-Pi-nsa,-*-,nek-Pi-fsi,-*-,nek-Pi-fsa
nekoga	nekdo-Pi-msg,-*-,nekdo-Pi-msa
nekolik	nekolik-Pi-msn,-*-,nekolik-Pi-msa
nekolika	nekolik-Pi-mdn,-*-,nekolik-Pi-mda,-*-,nekolik-Pi-npn,-*-,nekolik-Pi-npa,-*-,nekolik-Pi-fsn
nekolike	nekolik-Pi-mpa,-*-,nekolik-Pi-fsg,-*-,nekolik-Pi-fpn,-*-,nekolik-Pi-fpa
nekolikega	nekolik-Pi-msg,-*-,nekolik-Pi-msa,-*-,nekolik-Pi-nsg
nekolikem	nekolik-Pi-msl,-*-,nekolik-Pi-nsl
nekolikemu	nekolik-Pi-msd,-*-,nekolik-Pi-nsd
nekoliki	nekolik-Pi-mpn,-*-,nekolik-Pi-ndn,-*-,nekolik-Pi-nda,-*-,nekolik-Pi-fdn,-*-,nekolik-Pi-fda,-*-,nekolik-Pi-fsd,-*-,nekolik-Pi-fsl
nekolikih	nekolik-Pi-mdl,-*-,nekolik-Pi-mdg,-*-,nekolik-Pi-mpl,-*-,nekolik-Pi-mpg,-*-,nekolik-Pi-ndl,-*-,nekolik-Pi-ndg,-*-,nekolik-Pi-npl,-*-,nekolik-Pi-npg,-*-,nekolik-Pi-fdl,-*-,nekolik-Pi-fdg,-*-,nekolik-Pi-fpl,-*-,nekolik-Pi-fpg
nekolikim	nekolik-Pi-msi,-*-,nekolik-Pi-mpd,-*-,nekolik-Pi-nsi,-*-,nekolik-Pi-npd,-*-,nekolik-Pi-fpd
nekolikima	nekolik-Pi-mdd,-*-,nekolik-Pi-mdi,-*-,nekolik-Pi-ndd,-*-,nekolik-Pi-ndi,-*-,nekolik-Pi-fdd,-*-,nekolik-Pi-fdi
nekolikimi	nekolik-Pi-mpi,-*-,nekolik-Pi-npi,-*-,nekolik-Pi-fpi
nekoliko	nekolik-Pi-nsn,-*-,nekolik-Pi-nsa,-*-,nekolik-Pi-fsi,-*-,nekolik-Pi-fsa
nekolikšen	nekolikšen-Pi-msn,-*-,nekolikšen-Pi-msa
nekolikšna	nekolikšen-Pi-mdn,-*-,nekolikšen-Pi-mda,-*-,nekolikšen-Pi-npn,-*-,nekolikšen-Pi-npa,-*-,nekolikšen-Pi-fsn
nekolikšne	nekolikšen-Pi-mpa,-*-,nekolikšen-Pi-fsg,-*-,nekolikšen-Pi-fpn,-*-,nekolikšen-Pi-fpa
nekolikšnega	nekolikšen-Pi-msg,-*-,nekolikšen-Pi-msa,-*-,nekolikšen-Pi-nsg
nekolikšnem	nekolikšen-Pi-msl,-*-,nekolikšen-Pi-nsl
nekolikšnemu	nekolikšen-Pi-msd,-*-,nekolikšen-Pi-nsd
nekolikšni	nekolikšen-Pi-mpn,-*-,nekolikšen-Pi-ndn,-*-,nekolikšen-Pi-nda,-*-,nekolikšen-Pi-fdn,-*-,nekolikšen-Pi-fda,-*-,nekolikšen-Pi-fsd,-*-,nekolikšen-Pi-fsl
nekolikšnih	nekolikšen-Pi-mdl,-*-,nekolikšen-Pi-mdg,-*-,nekolikšen-Pi-mpl,-*-,nekolikšen-Pi-mpg,-*-,nekolikšen-Pi-ndl,-*-,nekolikšen-Pi-ndg,-*-,nekolikšen-Pi-npl,-*-,nekolikšen-Pi-npg,-*-,nekolikšen-Pi-fdl,-*-,nekolikšen-Pi-fdg,-*-,nekolikšen-Pi-fpl,-*-,nekolikšen-Pi-fpg
nekolikšnim	nekolikšen-Pi-msi,-*-,nekolikšen-Pi-mpd,-*-,nekolikšen-Pi-nsi,-*-,nekolikšen-Pi-npd,-*-,nekolikšen-Pi-fpd
nekolikšnima	nekolikšen-Pi-mdd,-*-,nekolikšen-Pi-mdi,-*-,nekolikšen-Pi-ndd,-*-,nekolikšen-Pi-ndi,-*-,nekolikšen-Pi-fdd,-*-,nekolikšen-Pi-fdi
nekolikšnimi	nekolikšen-Pi-mpi,-*-,nekolikšen-Pi-npi,-*-,nekolikšen-Pi-fpi
nekolikšnja	nekolikšnji-Pi-mdn,-*-,nekolikšnji-Pi-mda,-*-,nekolikšnji-Pi-npn,-*-,nekolikšnji-Pi-npa,-*-,nekolikšnji-Pi-fsn
nekolikšnje	nekolikšnji-Pi-mpa,-*-,nekolikšnji-Pi-nsn,-*-,nekolikšnji-Pi-nsa,-*-,nekolikšnji-Pi-fsg,-*-,nekolikšnji-Pi-fpn,-*-,nekolikšnji-Pi-fpa
nekolikšnjega	nekolikšnji-Pi-msg,-*-,nekolikšnji-Pi-msa,-*-,nekolikšnji-Pi-nsg
nekolikšnjem	nekolikšnji-Pi-msl,-*-,nekolikšnji-Pi-nsl
nekolikšnjemu	nekolikšnji-Pi-msd,-*-,nekolikšnji-Pi-nsd
nekolikšnji	nekolikšnji-Pi-msn,-*-,nekolikšnji-Pi-msa,-*-,nekolikšnji-Pi-mpn,-*-,nekolikšnji-Pi-ndn,-*-,nekolikšnji-Pi-nda,-*-,nekolikšnji-Pi-fdn,-*-,nekolikšnji-Pi-fda,-*-,nekolikšnji-Pi-fsd,-*-,nekolikšnji-Pi-fsl
nekolikšnjih	nekolikšnji-Pi-mdl,-*-,nekolikšnji-Pi-mdg,-*-,nekolikšnji-Pi-mpl,-*-,nekolikšnji-Pi-mpg,-*-,nekolikšnji-Pi-ndl,-*-,nekolikšnji-Pi-ndg,-*-,nekolikšnji-Pi-npl,-*-,nekolikšnji-Pi-npg,-*-,nekolikšnji-Pi-fdl,-*-,nekolikšnji-Pi-fdg,-*-,nekolikšnji-Pi-fpl,-*-,nekolikšnji-Pi-fpg
nekolikšnjim	nekolikšnji-Pi-msi,-*-,nekolikšnji-Pi-mpd,-*-,nekolikšnji-Pi-nsi,-*-,nekolikšnji-Pi-npd,-*-,nekolikšnji-Pi-fpd
nekolikšnjima	nekolikšnji-Pi-mdd,-*-,nekolikšnji-Pi-mdi,-*-,nekolikšnji-Pi-ndd,-*-,nekolikšnji-Pi-ndi,-*-,nekolikšnji-Pi-fdd,-*-,nekolikšnji-Pi-fdi
nekolikšnjimi	nekolikšnji-Pi-mpi,-*-,nekolikšnji-Pi-npi,-*-,nekolikšnji-Pi-fpi
nekolikšnjo	nekolikšnji-Pi-fsi,-*-,nekolikšnji-Pi-fsa
nekolikšno	nekolikšen-Pi-nsn,-*-,nekolikšen-Pi-nsa,-*-,nekolikšen-Pi-fsi,-*-,nekolikšen-Pi-fsa
nekom	nekdo-Pi-msl,-*-,nekdo-Pi-msi
nekomu	nekdo-Pi-msd
nekov	nekov-Pi-msn,-*-,nekov-Pi-msa
nekova	nekov-Pi-mdn,-*-,nekov-Pi-mda,-*-,nekov-Pi-npn,-*-,nekov-Pi-npa,-*-,nekov-Pi-fsn
nekove	nekov-Pi-mpa,-*-,nekov-Pi-fsg,-*-,nekov-Pi-fpn,-*-,nekov-Pi-fpa
nekovega	nekov-Pi-msg,-*-,nekov-Pi-msa,-*-,nekov-Pi-nsg
nekovem	nekov-Pi-msl,-*-,nekov-Pi-nsl
nekovemu	nekov-Pi-msd,-*-,nekov-Pi-nsd
nekovi	nekov-Pi-mpn,-*-,nekov-Pi-ndn,-*-,nekov-Pi-nda,-*-,nekov-Pi-fdn,-*-,nekov-Pi-fda,-*-,nekov-Pi-fsd,-*-,nekov-Pi-fsl
nekovih	nekov-Pi-mdl,-*-,nekov-Pi-mdg,-*-,nekov-Pi-mpl,-*-,nekov-Pi-mpg,-*-,nekov-Pi-ndl,-*-,nekov-Pi-ndg,-*-,nekov-Pi-npl,-*-,nekov-Pi-npg,-*-,nekov-Pi-fdl,-*-,nekov-Pi-fdg,-*-,nekov-Pi-fpl,-*-,nekov-Pi-fpg
nekovim	nekov-Pi-msi,-*-,nekov-Pi-mpd,-*-,nekov-Pi-nsi,-*-,nekov-Pi-npd,-*-,nekov-Pi-fpd
nekovima	nekov-Pi-mdd,-*-,nekov-Pi-mdi,-*-,nekov-Pi-ndd,-*-,nekov-Pi-ndi,-*-,nekov-Pi-fdd,-*-,nekov-Pi-fdi
nekovimi	nekov-Pi-mpi,-*-,nekov-Pi-npi,-*-,nekov-Pi-fpi
nekovo	nekov-Pi-nsn,-*-,nekov-Pi-nsa,-*-,nekov-Pi-fsi,-*-,nekov-Pi-fsa
nekšen	nekšen-Pi-msn,-*-,nekšen-Pi-msa
nekšna	nekšen-Pi-mdn,-*-,nekšen-Pi-mda,-*-,nekšen-Pi-npn,-*-,nekšen-Pi-npa,-*-,nekšen-Pi-fsn
nekšne	nekšen-Pi-mpa,-*-,nekšen-Pi-fsg,-*-,nekšen-Pi-fpn,-*-,nekšen-Pi-fpa
nekšnega	nekšen-Pi-msg,-*-,nekšen-Pi-msa,-*-,nekšen-Pi-nsg
nekšnem	nekšen-Pi-msl,-*-,nekšen-Pi-nsl
nekšnemu	nekšen-Pi-msd,-*-,nekšen-Pi-nsd
nekšni	nekšen-Pi-mpn,-*-,nekšen-Pi-ndn,-*-,nekšen-Pi-nda,-*-,nekšen-Pi-fdn,-*-,nekšen-Pi-fda,-*-,nekšen-Pi-fsd,-*-,nekšen-Pi-fsl
nekšnih	nekšen-Pi-mdl,-*-,nekšen-Pi-mdg,-*-,nekšen-Pi-mpl,-*-,nekšen-Pi-mpg,-*-,nekšen-Pi-ndl,-*-,nekšen-Pi-ndg,-*-,nekšen-Pi-npl,-*-,nekšen-Pi-npg,-*-,nekšen-Pi-fdl,-*-,nekšen-Pi-fdg,-*-,nekšen-Pi-fpl,-*-,nekšen-Pi-fpg
nekšnim	nekšen-Pi-msi,-*-,nekšen-Pi-mpd,-*-,nekšen-Pi-nsi,-*-,nekšen-Pi-npd,-*-,nekšen-Pi-fpd
nekšnima	nekšen-Pi-mdd,-*-,nekšen-Pi-mdi,-*-,nekšen-Pi-ndd,-*-,nekšen-Pi-ndi,-*-,nekšen-Pi-fdd,-*-,nekšen-Pi-fdi
nekšnimi	nekšen-Pi-mpi,-*-,nekšen-Pi-npi,-*-,nekšen-Pi-fpi
nekšno	nekšen-Pi-nsn,-*-,nekšen-Pi-nsa,-*-,nekšen-Pi-fsi,-*-,nekšen-Pi-fsa
nečem	nekaj-Pi-nsl
nečemu	nekaj-Pi-nsd
nečesa	nekaj-Pi-nsg
nečim	nekaj-Pi-nsi
nihče	nihče-Pz-msn
nikak	nikak-Pz-msn,-*-,nikak-Pz-msa
nikaka	nikak-Pz-mdn,-*-,nikak-Pz-mda,-*-,nikak-Pz-npn,-*-,nikak-Pz-npa,-*-,nikak-Pz-fsn
nikake	nikak-Pz-mpa,-*-,nikak-Pz-fsg,-*-,nikak-Pz-fpn,-*-,nikak-Pz-fpa
nikakega	nikak-Pz-msg,-*-,nikak-Pz-msa,-*-,nikak-Pz-nsg
nikakem	nikak-Pz-msl,-*-,nikak-Pz-nsl
nikakemu	nikak-Pz-msd,-*-,nikak-Pz-nsd
nikaki	nikak-Pz-mpn,-*-,nikak-Pz-ndn,-*-,nikak-Pz-nda,-*-,nikak-Pz-fdn,-*-,nikak-Pz-fda,-*-,nikak-Pz-fsd,-*-,nikak-Pz-fsl
nikakih	nikak-Pz-mdl,-*-,nikak-Pz-mdg,-*-,nikak-Pz-mpl,-*-,nikak-Pz-mpg,-*-,nikak-Pz-ndl,-*-,nikak-Pz-ndg,-*-,nikak-Pz-npl,-*-,nikak-Pz-npg,-*-,nikak-Pz-fdl,-*-,nikak-Pz-fdg,-*-,nikak-Pz-fpl,-*-,nikak-Pz-fpg
nikakim	nikak-Pz-msi,-*-,nikak-Pz-mpd,-*-,nikak-Pz-nsi,-*-,nikak-Pz-npd,-*-,nikak-Pz-fpd
nikakima	nikak-Pz-mdd,-*-,nikak-Pz-mdi,-*-,nikak-Pz-ndd,-*-,nikak-Pz-ndi,-*-,nikak-Pz-fdd,-*-,nikak-Pz-fdi
nikakimi	nikak-Pz-mpi,-*-,nikak-Pz-npi,-*-,nikak-Pz-fpi
nikako	nikak-Pz-nsn,-*-,nikak-Pz-nsa,-*-,nikak-Pz-fsi,-*-,nikak-Pz-fsa
nikakršen	nikakršen-Pz-msn,-*-,nikakršen-Pz-msa
nikakršna	nikakršen-Pz-mdn,-*-,nikakršen-Pz-mda,-*-,nikakršen-Pz-npn,-*-,nikakršen-Pz-npa,-*-,nikakršen-Pz-fsn
nikakršne	nikakršen-Pz-mpa,-*-,nikakršen-Pz-fsg,-*-,nikakršen-Pz-fpn,-*-,nikakršen-Pz-fpa
nikakršnega	nikakršen-Pz-msg,-*-,nikakršen-Pz-msa,-*-,nikakršen-Pz-nsg
nikakršnem	nikakršen-Pz-msl,-*-,nikakršen-Pz-nsl
nikakršnemu	nikakršen-Pz-msd,-*-,nikakršen-Pz-nsd
nikakršni	nikakršen-Pz-mpn,-*-,nikakršen-Pz-ndn,-*-,nikakršen-Pz-nda,-*-,nikakršen-Pz-fdn,-*-,nikakršen-Pz-fda,-*-,nikakršen-Pz-fsd,-*-,nikakršen-Pz-fsl
nikakršnih	nikakršen-Pz-mdl,-*-,nikakršen-Pz-mdg,-*-,nikakršen-Pz-mpl,-*-,nikakršen-Pz-mpg,-*-,nikakršen-Pz-ndl,-*-,nikakršen-Pz-ndg,-*-,nikakršen-Pz-npl,-*-,nikakršen-Pz-npg,-*-,nikakršen-Pz-fdl,-*-,nikakršen-Pz-fdg,-*-,nikakršen-Pz-fpl,-*-,nikakršen-Pz-fpg
nikakršnim	nikakršen-Pz-msi,-*-,nikakršen-Pz-mpd,-*-,nikakršen-Pz-nsi,-*-,nikakršen-Pz-npd,-*-,nikakršen-Pz-fpd
nikakršnima	nikakršen-Pz-mdd,-*-,nikakršen-Pz-mdi,-*-,nikakršen-Pz-ndd,-*-,nikakršen-Pz-ndi,-*-,nikakršen-Pz-fdd,-*-,nikakršen-Pz-fdi
nikakršnimi	nikakršen-Pz-mpi,-*-,nikakršen-Pz-npi,-*-,nikakršen-Pz-fpi
nikakršno	nikakršen-Pz-nsn,-*-,nikakršen-Pz-nsa,-*-,nikakršen-Pz-fsi,-*-,nikakršen-Pz-fsa
nikakšen	nikakšen-Pz-msn,-*-,nikakšen-Pz-msa
nikakšna	nikakšen-Pz-mdn,-*-,nikakšen-Pz-mda,-*-,nikakšen-Pz-npn,-*-,nikakšen-Pz-npa,-*-,nikakšen-Pz-fsn
nikakšne	nikakšen-Pz-mpa,-*-,nikakšen-Pz-fsg,-*-,nikakšen-Pz-fpn,-*-,nikakšen-Pz-fpa
nikakšnega	nikakšen-Pz-msg,-*-,nikakšen-Pz-msa,-*-,nikakšen-Pz-nsg
nikakšnem	nikakšen-Pz-msl,-*-,nikakšen-Pz-nsl
nikakšnemu	nikakšen-Pz-msd,-*-,nikakšen-Pz-nsd
nikakšni	nikakšen-Pz-mpn,-*-,nikakšen-Pz-ndn,-*-,nikakšen-Pz-nda,-*-,nikakšen-Pz-fdn,-*-,nikakšen-Pz-fda,-*-,nikakšen-Pz-fsd,-*-,nikakšen-Pz-fsl
nikakšnih	nikakšen-Pz-mdl,-*-,nikakšen-Pz-mdg,-*-,nikakšen-Pz-mpl,-*-,nikakšen-Pz-mpg,-*-,nikakšen-Pz-ndl,-*-,nikakšen-Pz-ndg,-*-,nikakšen-Pz-npl,-*-,nikakšen-Pz-npg,-*-,nikakšen-Pz-fdl,-*-,nikakšen-Pz-fdg,-*-,nikakšen-Pz-fpl,-*-,nikakšen-Pz-fpg
nikakšnim	nikakšen-Pz-msi,-*-,nikakšen-Pz-mpd,-*-,nikakšen-Pz-nsi,-*-,nikakšen-Pz-npd,-*-,nikakšen-Pz-fpd
nikakšnima	nikakšen-Pz-mdd,-*-,nikakšen-Pz-mdi,-*-,nikakšen-Pz-ndd,-*-,nikakšen-Pz-ndi,-*-,nikakšen-Pz-fdd,-*-,nikakšen-Pz-fdi
nikakšnimi	nikakšen-Pz-mpi,-*-,nikakšen-Pz-npi,-*-,nikakšen-Pz-fpi
nikakšno	nikakšen-Pz-nsn,-*-,nikakšen-Pz-nsa,-*-,nikakšen-Pz-fsi,-*-,nikakšen-Pz-fsa
nikdo	nikdo-Pz-msn
nikoga	nikdo-Pz-msg,-*-,nikdo-Pz-msa
nikogar	nihče-Pz-msg,-*-,nihče-Pz-msa
nikogaršen	nikogaršen-Pz-msn,-*-,nikogaršen-Pz-msa
nikogaršna	nikogaršen-Pz-mdn,-*-,nikogaršen-Pz-mda,-*-,nikogaršen-Pz-npn,-*-,nikogaršen-Pz-npa,-*-,nikogaršen-Pz-fsn
nikogaršne	nikogaršen-Pz-mpa,-*-,nikogaršen-Pz-fsg,-*-,nikogaršen-Pz-fpn,-*-,nikogaršen-Pz-fpa
nikogaršnega	nikogaršen-Pz-msg,-*-,nikogaršen-Pz-msa,-*-,nikogaršen-Pz-nsg
nikogaršnem	nikogaršen-Pz-msl,-*-,nikogaršen-Pz-nsl
nikogaršnemu	nikogaršen-Pz-msd,-*-,nikogaršen-Pz-nsd
nikogaršni	nikogaršen-Pz-mpn,-*-,nikogaršen-Pz-ndn,-*-,nikogaršen-Pz-nda,-*-,nikogaršen-Pz-fdn,-*-,nikogaršen-Pz-fda,-*-,nikogaršen-Pz-fsd,-*-,nikogaršen-Pz-fsl
nikogaršnih	nikogaršen-Pz-mdl,-*-,nikogaršen-Pz-mdg,-*-,nikogaršen-Pz-mpl,-*-,nikogaršen-Pz-mpg,-*-,nikogaršen-Pz-ndl,-*-,nikogaršen-Pz-ndg,-*-,nikogaršen-Pz-npl,-*-,nikogaršen-Pz-npg,-*-,nikogaršen-Pz-fdl,-*-,nikogaršen-Pz-fdg,-*-,nikogaršen-Pz-fpl,-*-,nikogaršen-Pz-fpg
nikogaršnim	nikogaršen-Pz-msi,-*-,nikogaršen-Pz-mpd,-*-,nikogaršen-Pz-nsi,-*-,nikogaršen-Pz-npd,-*-,nikogaršen-Pz-fpd
nikogaršnima	nikogaršen-Pz-mdd,-*-,nikogaršen-Pz-mdi,-*-,nikogaršen-Pz-ndd,-*-,nikogaršen-Pz-ndi,-*-,nikogaršen-Pz-fdd,-*-,nikogaršen-Pz-fdi
nikogaršnimi	nikogaršen-Pz-mpi,-*-,nikogaršen-Pz-npi,-*-,nikogaršen-Pz-fpi
nikogaršnja	nikogaršnji-Pz-mdn,-*-,nikogaršnji-Pz-mda,-*-,nikogaršnji-Pz-npn,-*-,nikogaršnji-Pz-npa,-*-,nikogaršnji-Pz-fsn
nikogaršnje	nikogaršnji-Pz-mpa,-*-,nikogaršnji-Pz-nsn,-*-,nikogaršnji-Pz-nsa,-*-,nikogaršnji-Pz-fsg,-*-,nikogaršnji-Pz-fpn,-*-,nikogaršnji-Pz-fpa
nikogaršnjega	nikogaršnji-Pz-msg,-*-,nikogaršnji-Pz-msa,-*-,nikogaršnji-Pz-nsg
nikogaršnjem	nikogaršnji-Pz-msl,-*-,nikogaršnji-Pz-nsl
nikogaršnjemu	nikogaršnji-Pz-msd,-*-,nikogaršnji-Pz-nsd
nikogaršnji	nikogaršnji-Pz-msn,-*-,nikogaršnji-Pz-msa,-*-,nikogaršnji-Pz-mpn,-*-,nikogaršnji-Pz-ndn,-*-,nikogaršnji-Pz-nda,-*-,nikogaršnji-Pz-fdn,-*-,nikogaršnji-Pz-fda,-*-,nikogaršnji-Pz-fsd,-*-,nikogaršnji-Pz-fsl
nikogaršnjih	nikogaršnji-Pz-mdl,-*-,nikogaršnji-Pz-mdg,-*-,nikogaršnji-Pz-mpl,-*-,nikogaršnji-Pz-mpg,-*-,nikogaršnji-Pz-ndl,-*-,nikogaršnji-Pz-ndg,-*-,nikogaršnji-Pz-npl,-*-,nikogaršnji-Pz-npg,-*-,nikogaršnji-Pz-fdl,-*-,nikogaršnji-Pz-fdg,-*-,nikogaršnji-Pz-fpl,-*-,nikogaršnji-Pz-fpg
nikogaršnjim	nikogaršnji-Pz-msi,-*-,nikogaršnji-Pz-mpd,-*-,nikogaršnji-Pz-nsi,-*-,nikogaršnji-Pz-npd,-*-,nikogaršnji-Pz-fpd
nikogaršnjima	nikogaršnji-Pz-mdd,-*-,nikogaršnji-Pz-mdi,-*-,nikogaršnji-Pz-ndd,-*-,nikogaršnji-Pz-ndi,-*-,nikogaršnji-Pz-fdd,-*-,nikogaršnji-Pz-fdi
nikogaršnjimi	nikogaršnji-Pz-mpi,-*-,nikogaršnji-Pz-npi,-*-,nikogaršnji-Pz-fpi
nikogaršnjo	nikogaršnji-Pz-fsi,-*-,nikogaršnji-Pz-fsa
nikogaršno	nikogaršen-Pz-nsn,-*-,nikogaršen-Pz-nsa,-*-,nikogaršen-Pz-fsi,-*-,nikogaršen-Pz-fsa
nikom	nikdo-Pz-msl,-*-,nikdo-Pz-msi
nikomer	nihče-Pz-msl,-*-,nihče-Pz-msi
nikomu	nikdo-Pz-msd
nikomur	nihče-Pz-msd
nič	nič-Pz-nsn,-*-,nič-Pz-nsa
ničemer	nič-Pz-nsl
ničemur	nič-Pz-nsd
ničesar	nič-Pz-nsg
ničimer	nič-Pz-nsi
nje	on-Pp3mpa,-*-,on-Pp3npa,-*-,on-Pp3fsg,-*-,on-Pp3fpa
njega	on-Pp3msg,-*-,on-Pp3msa,-*-,on-Pp3nsg
njegov	njegov-Ps3msnsm,-*-,njegov-Ps3msnsn,-*-,njegov-Ps3msasm,-*-,njegov-Ps3msasn
njegova	njegov-Ps3mdnsm,-*-,njegov-Ps3mdnsn,-*-,njegov-Ps3mdasm,-*-,njegov-Ps3mdasn,-*-,njegov-Ps3npnsm,-*-,njegov-Ps3npnsn,-*-,njegov-Ps3npasm,-*-,njegov-Ps3npasn,-*-,njegov-Ps3fsnsm,-*-,njegov-Ps3fsnsn
njegove	njegov-Ps3mpasm,-*-,njegov-Ps3mpasn,-*-,njegov-Ps3fsgsm,-*-,njegov-Ps3fsgsn,-*-,njegov-Ps3fpnsm,-*-,njegov-Ps3fpnsn,-*-,njegov-Ps3fpasm,-*-,njegov-Ps3fpasn
njegovega	njegov-Ps3msgsm,-*-,njegov-Ps3msgsn,-*-,njegov-Ps3msasm,-*-,njegov-Ps3msasn,-*-,njegov-Ps3nsgsm,-*-,njegov-Ps3nsgsn
njegovem	njegov-Ps3mslsm,-*-,njegov-Ps3mslsn,-*-,njegov-Ps3nslsm,-*-,njegov-Ps3nslsn
njegovemu	njegov-Ps3msdsm,-*-,njegov-Ps3msdsn,-*-,njegov-Ps3nsdsm,-*-,njegov-Ps3nsdsn
njegovi	njegov-Ps3mpnsm,-*-,njegov-Ps3mpnsn,-*-,njegov-Ps3ndnsm,-*-,njegov-Ps3ndnsn,-*-,njegov-Ps3ndasm,-*-,njegov-Ps3ndasn,-*-,njegov-Ps3fdnsm,-*-,njegov-Ps3fdnsn,-*-,njegov-Ps3fdasm,-*-,njegov-Ps3fdasn,-*-,njegov-Ps3fsdsm,-*-,njegov-Ps3fsdsn,-*-,njegov-Ps3fslsm,-*-,njegov-Ps3fslsn
njegovih	njegov-Ps3mdlsm,-*-,njegov-Ps3mdlsn,-*-,njegov-Ps3mdgsm,-*-,njegov-Ps3mdgsn,-*-,njegov-Ps3mplsm,-*-,njegov-Ps3mplsn,-*-,njegov-Ps3mpgsm,-*-,njegov-Ps3mpgsn,-*-,njegov-Ps3ndlsm,-*-,njegov-Ps3ndlsn,-*-,njegov-Ps3ndgsm,-*-,njegov-Ps3ndgsn,-*-,njegov-Ps3nplsm,-*-,njegov-Ps3nplsn,-*-,njegov-Ps3npgsm,-*-,njegov-Ps3npgsn,-*-,njegov-Ps3fdlsm,-*-,njegov-Ps3fdlsn,-*-,njegov-Ps3fdgsm,-*-,njegov-Ps3fdgsn,-*-,njegov-Ps3fplsm,-*-,njegov-Ps3fplsn,-*-,njegov-Ps3fpgsm,-*-,njegov-Ps3fpgsn
njegovim	njegov-Ps3msism,-*-,njegov-Ps3msisn,-*-,njegov-Ps3mpdsm,-*-,njegov-Ps3mpdsn,-*-,njegov-Ps3nsism,-*-,njegov-Ps3nsisn,-*-,njegov-Ps3npdsm,-*-,njegov-Ps3npdsn,-*-,njegov-Ps3fpdsm,-*-,njegov-Ps3fpdsn
njegovima	njegov-Ps3mddsm,-*-,njegov-Ps3mddsn,-*-,njegov-Ps3mdism,-*-,njegov-Ps3mdisn,-*-,njegov-Ps3nddsm,-*-,njegov-Ps3nddsn,-*-,njegov-Ps3ndism,-*-,njegov-Ps3ndisn,-*-,njegov-Ps3fddsm,-*-,njegov-Ps3fddsn,-*-,njegov-Ps3fdism,-*-,njegov-Ps3fdisn
njegovimi	njegov-Ps3mpism,-*-,njegov-Ps3mpisn,-*-,njegov-Ps3npism,-*-,njegov-Ps3npisn,-*-,njegov-Ps3fpism,-*-,njegov-Ps3fpisn
njegovo	njegov-Ps3nsnsm,-*-,njegov-Ps3nsnsn,-*-,njegov-Ps3nsasm,-*-,njegov-Ps3nsasn,-*-,njegov-Ps3fsism,-*-,njegov-Ps3fsisn,-*-,njegov-Ps3fsasm,-*-,njegov-Ps3fsasn
njej	on-Pp3fsd,-*-,on-Pp3fsl
njem	on-Pp3msl,-*-,on-Pp3nsl
njemu	on-Pp3msd,-*-,on-Pp3nsd
njen	njen-Ps3msnsf,-*-,njen-Ps3msasf
njena	njen-Ps3mdnsf,-*-,njen-Ps3mdasf,-*-,njen-Ps3npnsf,-*-,njen-Ps3npasf,-*-,njen-Ps3fsnsf
njene	njen-Ps3mpasf,-*-,njen-Ps3fsgsf,-*-,njen-Ps3fpnsf,-*-,njen-Ps3fpasf
njenega	njen-Ps3msgsf,-*-,njen-Ps3msasf,-*-,njen-Ps3nsgsf
njenem	njen-Ps3mslsf,-*-,njen-Ps3nslsf
njenemu	njen-Ps3msdsf,-*-,njen-Ps3nsdsf
njeni	njen-Ps3mpnsf,-*-,njen-Ps3ndnsf,-*-,njen-Ps3ndasf,-*-,njen-Ps3fdnsf,-*-,njen-Ps3fdasf,-*-,njen-Ps3fsdsf,-*-,njen-Ps3fslsf
njenih	njen-Ps3mdlsf,-*-,njen-Ps3mdgsf,-*-,njen-Ps3mplsf,-*-,njen-Ps3mpgsf,-*-,njen-Ps3ndlsf,-*-,njen-Ps3ndgsf,-*-,njen-Ps3nplsf,-*-,njen-Ps3npgsf,-*-,njen-Ps3fdlsf,-*-,njen-Ps3fdgsf,-*-,njen-Ps3fplsf,-*-,njen-Ps3fpgsf
njenim	njen-Ps3msisf,-*-,njen-Ps3mpdsf,-*-,njen-Ps3nsisf,-*-,njen-Ps3npdsf,-*-,njen-Ps3fpdsf
njenima	njen-Ps3mddsf,-*-,njen-Ps3mdisf,-*-,njen-Ps3nddsf,-*-,njen-Ps3ndisf,-*-,njen-Ps3fddsf,-*-,njen-Ps3fdisf
njenimi	njen-Ps3mpisf,-*-,njen-Ps3npisf,-*-,njen-Ps3fpisf
njeno	njen-Ps3nsnsf,-*-,njen-Ps3nsasf,-*-,njen-Ps3fsisf,-*-,njen-Ps3fsasf
nji	on-Pp3fsd,-*-,on-Pp3fsl
njih	on-Pp3mdg,-*-,on-Pp3mpl,-*-,on-Pp3mpg,-*-,on-Pp3mpa,-*-,on-Pp3npl,-*-,on-Pp3npg,-*-,on-Pp3npa,-*-,on-Pp3fpl,-*-,on-Pp3fpg,-*-,on-Pp3fpa
njihen	njihen-Ps3msnp,-*-,njihen-Ps3msap
njihna	njihen-Ps3mdnp,-*-,njihen-Ps3mdap,-*-,njihen-Ps3npnp,-*-,njihen-Ps3npap,-*-,njihen-Ps3fsnp
njihne	njihen-Ps3mpap,-*-,njihen-Ps3fsgp,-*-,njihen-Ps3fpnp,-*-,njihen-Ps3fpap
njihnega	njihen-Ps3msgp,-*-,njihen-Ps3msap,-*-,njihen-Ps3nsgp
njihnem	njihen-Ps3mslp,-*-,njihen-Ps3nslp
njihnemu	njihen-Ps3msdp,-*-,njihen-Ps3nsdp
njihni	njihen-Ps3mpnp,-*-,njihen-Ps3ndnp,-*-,njihen-Ps3ndap,-*-,njihen-Ps3fdnp,-*-,njihen-Ps3fdap,-*-,njihen-Ps3fsdp,-*-,njihen-Ps3fslp
njihnih	njihen-Ps3mdlp,-*-,njihen-Ps3mdgp,-*-,njihen-Ps3mplp,-*-,njihen-Ps3mpgp,-*-,njihen-Ps3ndlp,-*-,njihen-Ps3ndgp,-*-,njihen-Ps3nplp,-*-,njihen-Ps3npgp,-*-,njihen-Ps3fdlp,-*-,njihen-Ps3fdgp,-*-,njihen-Ps3fplp,-*-,njihen-Ps3fpgp
njihnim	njihen-Ps3msip,-*-,njihen-Ps3mpdp,-*-,njihen-Ps3nsip,-*-,njihen-Ps3npdp,-*-,njihen-Ps3fpdp
njihnima	njihen-Ps3mddp,-*-,njihen-Ps3mdip,-*-,njihen-Ps3nddp,-*-,njihen-Ps3ndip,-*-,njihen-Ps3fddp,-*-,njihen-Ps3fdip
njihnimi	njihen-Ps3mpip,-*-,njihen-Ps3npip,-*-,njihen-Ps3fpip
njihnja	njihnji-Ps3mdnp,-*-,njihnji-Ps3mdap,-*-,njihnji-Ps3npnp,-*-,njihnji-Ps3npap,-*-,njihnji-Ps3fsnp
njihnje	njihnji-Ps3mpap,-*-,njihnji-Ps3nsnp,-*-,njihnji-Ps3nsap,-*-,njihnji-Ps3fsgp,-*-,njihnji-Ps3fpnp,-*-,njihnji-Ps3fpap
njihnjega	njihnji-Ps3msgp,-*-,njihnji-Ps3msap,-*-,njihnji-Ps3nsgp
njihnjem	njihnji-Ps3mslp,-*-,njihnji-Ps3nslp
njihnjemu	njihnji-Ps3msdp,-*-,njihnji-Ps3nsdp
njihnji	njihnji-Ps3msnp,-*-,njihnji-Ps3msap,-*-,njihnji-Ps3mpnp,-*-,njihnji-Ps3ndnp,-*-,njihnji-Ps3ndap,-*-,njihnji-Ps3fdnp,-*-,njihnji-Ps3fdap,-*-,njihnji-Ps3fsdp,-*-,njihnji-Ps3fslp
njihnjih	njihnji-Ps3mdlp,-*-,njihnji-Ps3mdgp,-*-,njihnji-Ps3mplp,-*-,njihnji-Ps3mpgp,-*-,njihnji-Ps3ndlp,-*-,njihnji-Ps3ndgp,-*-,njihnji-Ps3nplp,-*-,njihnji-Ps3npgp,-*-,njihnji-Ps3fdlp,-*-,njihnji-Ps3fdgp,-*-,njihnji-Ps3fplp,-*-,njihnji-Ps3fpgp
njihnjim	njihnji-Ps3msip,-*-,njihnji-Ps3mpdp,-*-,njihnji-Ps3nsip,-*-,njihnji-Ps3npdp,-*-,njihnji-Ps3fpdp
njihnjima	njihnji-Ps3mddp,-*-,njihnji-Ps3mdip,-*-,njihnji-Ps3nddp,-*-,njihnji-Ps3ndip,-*-,njihnji-Ps3fddp,-*-,njihnji-Ps3fdip
njihnjimi	njihnji-Ps3mpip,-*-,njihnji-Ps3npip,-*-,njihnji-Ps3fpip
njihnjo	njihnji-Ps3fsip,-*-,njihnji-Ps3fsap
njihno	njihen-Ps3nsnp,-*-,njihen-Ps3nsap,-*-,njihen-Ps3fsip,-*-,njihen-Ps3fsap
njihov	njihov-Ps3msnp,-*-,njihov-Ps3msap
njihova	njihov-Ps3mdnp,-*-,njihov-Ps3mdap,-*-,njihov-Ps3npnp,-*-,njihov-Ps3npap,-*-,njihov-Ps3fsnp
njihove	njihov-Ps3mpap,-*-,njihov-Ps3fsgp,-*-,njihov-Ps3fpnp,-*-,njihov-Ps3fpap
njihovega	njihov-Ps3msgp,-*-,njihov-Ps3msap,-*-,njihov-Ps3nsgp
njihovem	njihov-Ps3mslp,-*-,njihov-Ps3nslp
njihovemu	njihov-Ps3msdp,-*-,njihov-Ps3nsdp
njihovi	njihov-Ps3mpnp,-*-,njihov-Ps3ndnp,-*-,njihov-Ps3ndap,-*-,njihov-Ps3fdnp,-*-,njihov-Ps3fdap,-*-,njihov-Ps3fsdp,-*-,njihov-Ps3fslp
njihovih	njihov-Ps3mdlp,-*-,njihov-Ps3mdgp,-*-,njihov-Ps3mplp,-*-,njihov-Ps3mpgp,-*-,njihov-Ps3ndlp,-*-,njihov-Ps3ndgp,-*-,njihov-Ps3nplp,-*-,njihov-Ps3npgp,-*-,njihov-Ps3fdlp,-*-,njihov-Ps3fdgp,-*-,njihov-Ps3fplp,-*-,njihov-Ps3fpgp
njihovim	njihov-Ps3msip,-*-,njihov-Ps3mpdp,-*-,njihov-Ps3nsip,-*-,njihov-Ps3npdp,-*-,njihov-Ps3fpdp
njihovima	njihov-Ps3mddp,-*-,njihov-Ps3mdip,-*-,njihov-Ps3nddp,-*-,njihov-Ps3ndip,-*-,njihov-Ps3fddp,-*-,njihov-Ps3fdip
njihovimi	njihov-Ps3mpip,-*-,njihov-Ps3npip,-*-,njihov-Ps3fpip
njihovo	njihov-Ps3nsnp,-*-,njihov-Ps3nsap,-*-,njihov-Ps3fsip,-*-,njihov-Ps3fsap
njiju	on-Pp3mdl,-*-,on-Pp3mdg,-*-,on-Pp3mda,-*-,on-Pp3ndl,-*-,on-Pp3ndg,-*-,on-Pp3nda,-*-,on-Pp3fdl,-*-,on-Pp3fdg,-*-,on-Pp3fda
njim	on-Pp3msi,-*-,on-Pp3mpd,-*-,on-Pp3nsi,-*-,on-Pp3npd,-*-,on-Pp3fpd
njima	on-Pp3mdd,-*-,on-Pp3mdi,-*-,on-Pp3ndd,-*-,on-Pp3ndl,-*-,on-Pp3ndi,-*-,on-Pp3fdd,-*-,on-Pp3fdl,-*-,on-Pp3fdi
njimi	on-Pp3mpi,-*-,on-Pp3npi,-*-,on-Pp3fpi
njo	on-Pp3fsi,-*-,on-Pp3fsa
njun	njun-Ps3msnd,-*-,njun-Ps3msad
njuna	njun-Ps3mdnd,-*-,njun-Ps3mdad,-*-,njun-Ps3npnd,-*-,njun-Ps3npad,-*-,njun-Ps3fsnd
njune	njun-Ps3mpad,-*-,njun-Ps3fsgd,-*-,njun-Ps3fpnd,-*-,njun-Ps3fpad
njunega	njun-Ps3msgd,-*-,njun-Ps3msad,-*-,njun-Ps3nsgd
njunem	njun-Ps3msld,-*-,njun-Ps3nsld
njunemu	njun-Ps3msdd,-*-,njun-Ps3nsdd
njuni	njun-Ps3mpnd,-*-,njun-Ps3ndnd,-*-,njun-Ps3ndad,-*-,njun-Ps3fdnd,-*-,njun-Ps3fdad,-*-,njun-Ps3fsdd,-*-,njun-Ps3fsld
njunih	njun-Ps3mdld,-*-,njun-Ps3mdgd,-*-,njun-Ps3mpld,-*-,njun-Ps3mpgd,-*-,njun-Ps3ndld,-*-,njun-Ps3ndgd,-*-,njun-Ps3npld,-*-,njun-Ps3npgd,-*-,njun-Ps3fdld,-*-,njun-Ps3fdgd,-*-,njun-Ps3fpld,-*-,njun-Ps3fpgd
njunim	njun-Ps3msid,-*-,njun-Ps3mpdd,-*-,njun-Ps3nsid,-*-,njun-Ps3npdd,-*-,njun-Ps3fpdd
njunima	njun-Ps3mddd,-*-,njun-Ps3mdid,-*-,njun-Ps3nddd,-*-,njun-Ps3ndid,-*-,njun-Ps3fddd,-*-,njun-Ps3fdid
njunimi	njun-Ps3mpid,-*-,njun-Ps3npid,-*-,njun-Ps3fpid
njuno	njun-Ps3nsnd,-*-,njun-Ps3nsad,-*-,njun-Ps3fsid,-*-,njun-Ps3fsad
nobeden	nobeden-Pz-msn
noben	noben-Pz-msn,-*-,noben-Pz-msa
nobena	noben-Pz-mdn,-*-,noben-Pz-mda,-*-,noben-Pz-npn,-*-,noben-Pz-npa,-*-,noben-Pz-fsn
nobene	noben-Pz-mpa,-*-,noben-Pz-fsg,-*-,noben-Pz-fpn,-*-,noben-Pz-fpa
nobenega	noben-Pz-msg,-*-,noben-Pz-msa,-*-,noben-Pz-nsg
nobenem	noben-Pz-msl,-*-,noben-Pz-nsl
nobenemu	noben-Pz-msd,-*-,noben-Pz-nsd
nobeni	noben-Pz-mpn,-*-,noben-Pz-ndn,-*-,noben-Pz-nda,-*-,noben-Pz-fdn,-*-,noben-Pz-fda,-*-,noben-Pz-fsd,-*-,noben-Pz-fsl
nobenih	noben-Pz-mdl,-*-,noben-Pz-mdg,-*-,noben-Pz-mpl,-*-,noben-Pz-mpg,-*-,noben-Pz-ndl,-*-,noben-Pz-ndg,-*-,noben-Pz-npl,-*-,noben-Pz-npg,-*-,noben-Pz-fdl,-*-,noben-Pz-fdg,-*-,noben-Pz-fpl,-*-,noben-Pz-fpg
nobenim	noben-Pz-msi,-*-,noben-Pz-mpd,-*-,noben-Pz-nsi,-*-,noben-Pz-npd,-*-,noben-Pz-fpd
nobenima	noben-Pz-mdd,-*-,noben-Pz-mdi,-*-,noben-Pz-ndd,-*-,noben-Pz-ndi,-*-,noben-Pz-fdd,-*-,noben-Pz-fdi
nobenimi	noben-Pz-mpi,-*-,noben-Pz-npi,-*-,noben-Pz-fpi
nobeno	noben-Pz-nsn,-*-,noben-Pz-nsa,-*-,noben-Pz-fsi,-*-,noben-Pz-fsa
oba	oba-Pg-mdn,-*-,oba-Pg-mda
obadva	obadva-Pg-mdn,-*-,obadva-Pg-mda
obe	oba-Pg-ndn,-*-,oba-Pg-nda,-*-,oba-Pg-fdn,-*-,oba-Pg-fda
obedve	obadva-Pg-ndn,-*-,obadva-Pg-nda,-*-,obadva-Pg-fdn,-*-,obadva-Pg-fda
obeh	oba-Pg-mdl,-*-,oba-Pg-mdg,-*-,oba-Pg-ndl,-*-,oba-Pg-ndg,-*-,oba-Pg-fdl,-*-,oba-Pg-fdg
obema	oba-Pg-mdd,-*-,oba-Pg-mdi,-*-,oba-Pg-ndd,-*-,oba-Pg-ndi,-*-,oba-Pg-fdd,-*-,oba-Pg-fdi
obenj	obme-Pp3msa--b,-*-,obme-Pp3nsa--b
obme	obme-Pp1-sa--b
obnje	obme-Pp3mpa--b,-*-,obme-Pp3npa--b,-*-,obme-Pp3fpa--b
obnjo	obme-Pp3fsa--b
obnju	obme-Pp3mda--b,-*-,obme-Pp3nda--b,-*-,obme-Pp3fda--b
oboj	oboj-Pg-msn,-*-,oboj-Pg-msa
oboja	oboj-Pg-mdn,-*-,oboj-Pg-mda,-*-,oboj-Pg-npn,-*-,oboj-Pg-npa,-*-,oboj-Pg-fsn
oboje	oboj-Pg-mpa,-*-,oboj-Pg-nsn,-*-,oboj-Pg-nsa,-*-,oboj-Pg-fsg,-*-,oboj-Pg-fpn,-*-,oboj-Pg-fpa
obojega	oboj-Pg-msg,-*-,oboj-Pg-msa,-*-,oboj-Pg-nsg
obojem	oboj-Pg-msl,-*-,oboj-Pg-nsl
obojemu	oboj-Pg-msd,-*-,oboj-Pg-nsd
obojen	obojen-Pg-msn,-*-,obojen-Pg-msa
oboji	oboj-Pg-mpn,-*-,oboj-Pg-ndn,-*-,oboj-Pg-nda,-*-,oboj-Pg-fdn,-*-,oboj-Pg-fda,-*-,oboj-Pg-fsd,-*-,oboj-Pg-fsl
obojih	oboj-Pg-mdl,-*-,oboj-Pg-mdg,-*-,oboj-Pg-mpl,-*-,oboj-Pg-mpg,-*-,oboj-Pg-ndl,-*-,oboj-Pg-ndg,-*-,oboj-Pg-npl,-*-,oboj-Pg-npg,-*-,oboj-Pg-fdl,-*-,oboj-Pg-fdg,-*-,oboj-Pg-fpl,-*-,oboj-Pg-fpg
obojim	oboj-Pg-msi,-*-,oboj-Pg-mpd,-*-,oboj-Pg-nsi,-*-,oboj-Pg-npd,-*-,oboj-Pg-fpd
obojima	oboj-Pg-mdd,-*-,oboj-Pg-mdi,-*-,oboj-Pg-ndd,-*-,oboj-Pg-ndi,-*-,oboj-Pg-fdd,-*-,oboj-Pg-fdi
obojimi	oboj-Pg-mpi,-*-,oboj-Pg-npi,-*-,oboj-Pg-fpi
obojna	obojen-Pg-mdn,-*-,obojen-Pg-mda,-*-,obojen-Pg-npn,-*-,obojen-Pg-npa,-*-,obojen-Pg-fsn
obojne	obojen-Pg-mpa,-*-,obojen-Pg-fsg,-*-,obojen-Pg-fpn,-*-,obojen-Pg-fpa
obojnega	obojen-Pg-msg,-*-,obojen-Pg-msa,-*-,obojen-Pg-nsg
obojnem	obojen-Pg-msl,-*-,obojen-Pg-nsl
obojnemu	obojen-Pg-msd,-*-,obojen-Pg-nsd
obojni	obojen-Pg-mpn,-*-,obojen-Pg-ndn,-*-,obojen-Pg-nda,-*-,obojen-Pg-fdn,-*-,obojen-Pg-fda,-*-,obojen-Pg-fsd,-*-,obojen-Pg-fsl
obojnih	obojen-Pg-mdl,-*-,obojen-Pg-mdg,-*-,obojen-Pg-mpl,-*-,obojen-Pg-mpg,-*-,obojen-Pg-ndl,-*-,obojen-Pg-ndg,-*-,obojen-Pg-npl,-*-,obojen-Pg-npg,-*-,obojen-Pg-fdl,-*-,obojen-Pg-fdg,-*-,obojen-Pg-fpl,-*-,obojen-Pg-fpg
obojnim	obojen-Pg-msi,-*-,obojen-Pg-mpd,-*-,obojen-Pg-nsi,-*-,obojen-Pg-npd,-*-,obojen-Pg-fpd
obojnima	obojen-Pg-mdd,-*-,obojen-Pg-mdi,-*-,obojen-Pg-ndd,-*-,obojen-Pg-ndi,-*-,obojen-Pg-fdd,-*-,obojen-Pg-fdi
obojnimi	obojen-Pg-mpi,-*-,obojen-Pg-npi,-*-,obojen-Pg-fpi
obojno	obojen-Pg-nsn,-*-,obojen-Pg-nsa,-*-,obojen-Pg-fsi,-*-,obojen-Pg-fsa
obojo	oboj-Pg-fsi,-*-,oboj-Pg-fsa
obse	obse-Px---a--b
obte	obme-Pp2-sa--b
on	on-Pp3msn
ona	on-Pp3npn,-*-,on-Pp3fsn,-*-,oni-Pd-mdn,-*-,oni-Pd-mda,-*-,oni-Pd-npn,-*-,oni-Pd-npa,-*-,oni-Pd-fsn
onadva	on-Pp3mdn
onale	onile-Pd-mdn,-*-,onile-Pd-mda,-*-,onile-Pd-npn,-*-,onile-Pd-npa,-*-,onile-Pd-fsn
one	on-Pp3fpn,-*-,oni-Pd-mpa,-*-,oni-Pd-fsg,-*-,oni-Pd-fpn,-*-,oni-Pd-fpa
onedve	on-Pp3ndn,-*-,on-Pp3fdn
onega	oni-Pd-msg,-*-,oni-Pd-msa,-*-,oni-Pd-nsg
onegale	onile-Pd-msg,-*-,onile-Pd-msa,-*-,onile-Pd-nsg
onele	onile-Pd-mpa,-*-,onile-Pd-fsg,-*-,onile-Pd-fpn,-*-,onile-Pd-fpa
onem	oni-Pd-msl,-*-,oni-Pd-nsl
onemle	onile-Pd-msl,-*-,onile-Pd-nsl
onemu	oni-Pd-msd,-*-,oni-Pd-nsd
onemule	onile-Pd-msd,-*-,onile-Pd-nsd
oni	on-Pp3mpn,-*-,oni-Pd-msn,-*-,oni-Pd-msa,-*-,oni-Pd-mpn,-*-,oni-Pd-ndn,-*-,oni-Pd-nda,-*-,oni-Pd-fdn,-*-,oni-Pd-fda,-*-,oni-Pd-fsd,-*-,oni-Pd-fsl
onidve	on-Pp3ndn,-*-,on-Pp3fdn
onih	oni-Pd-mdl,-*-,oni-Pd-mdg,-*-,oni-Pd-mpl,-*-,oni-Pd-mpg,-*-,oni-Pd-ndl,-*-,oni-Pd-ndg,-*-,oni-Pd-npl,-*-,oni-Pd-npg,-*-,oni-Pd-fdl,-*-,oni-Pd-fdg,-*-,oni-Pd-fpl,-*-,oni-Pd-fpg
onihle	onile-Pd-mdl,-*-,onile-Pd-mdg,-*-,onile-Pd-mpl,-*-,onile-Pd-mpg,-*-,onile-Pd-ndl,-*-,onile-Pd-ndg,-*-,onile-Pd-npl,-*-,onile-Pd-npg,-*-,onile-Pd-fdl,-*-,onile-Pd-fdg,-*-,onile-Pd-fpl,-*-,onile-Pd-fpg
onile	onile-Pd-msn,-*-,onile-Pd-msa,-*-,onile-Pd-mpn,-*-,onile-Pd-ndn,-*-,onile-Pd-nda,-*-,onile-Pd-fdn,-*-,onile-Pd-fda,-*-,onile-Pd-fsd,-*-,onile-Pd-fsl
onim	oni-Pd-msi,-*-,oni-Pd-mpd,-*-,oni-Pd-nsi,-*-,oni-Pd-npd,-*-,oni-Pd-fpd
onima	oni-Pd-mdd,-*-,oni-Pd-mdi,-*-,oni-Pd-ndd,-*-,oni-Pd-ndi,-*-,oni-Pd-fdd,-*-,oni-Pd-fdi
onimale	onile-Pd-mdd,-*-,onile-Pd-mdi,-*-,onile-Pd-ndd,-*-,onile-Pd-ndi,-*-,onile-Pd-fdd,-*-,onile-Pd-fdi
onimi	oni-Pd-mpi,-*-,oni-Pd-npi,-*-,oni-Pd-fpi
onimile	onile-Pd-mpi,-*-,onile-Pd-npi,-*-,onile-Pd-fpi
onimle	onile-Pd-msi,-*-,onile-Pd-mpd,-*-,onile-Pd-nsi,-*-,onile-Pd-npd,-*-,onile-Pd-fpd
ono	on-Pp3nsn,-*-,on-Pp3nsa,-*-,oni-Pd-nsn,-*-,oni-Pd-nsa,-*-,oni-Pd-fsi,-*-,oni-Pd-fsa
onole	onile-Pd-nsn,-*-,onile-Pd-nsa,-*-,onile-Pd-fsi,-*-,onile-Pd-fsa
podenj	podme-Pp3msa--b,-*-,podme-Pp3nsa--b
podme	podme-Pp1-sa--b
podnje	podme-Pp3mpa--b,-*-,podme-Pp3npa--b,-*-,podme-Pp3fpa--b
podnjo	podme-Pp3fsa--b
podnju	podme-Pp3mda--b,-*-,podme-Pp3nda--b,-*-,podme-Pp3fda--b
podse	podse-Px---a--b
podte	podme-Pp2-sa--b
pome	pome-Pp1-sa--b
ponj	pome-Pp3msa--b,-*-,pome-Pp3nsa--b
ponje	pome-Pp3mpa--b,-*-,pome-Pp3npa--b,-*-,pome-Pp3fpa--b
ponjo	pome-Pp3fsa--b
ponju	pome-Pp3mda--b,-*-,pome-Pp3nda--b,-*-,pome-Pp3fda--b
pote	pome-Pp2-sa--b
predenj	predme-Pp3msa--b,-*-,predme-Pp3nsa--b
predme	predme-Pp1-sa--b
prednje	predme-Pp3mpa--b,-*-,predme-Pp3npa--b,-*-,predme-Pp3fpa--b
prednjo	predme-Pp3fsa--b
prednju	predme-Pp3mda--b,-*-,predme-Pp3nda--b,-*-,predme-Pp3fda--b
predse	predse-Px---a--b
predte	predme-Pp2-sa--b
premarsikatera	premarsikateri-Pi-mdn,-*-,premarsikateri-Pi-mda,-*-,premarsikateri-Pi-npn,-*-,premarsikateri-Pi-npa,-*-,premarsikateri-Pi-fsn
premarsikatere	premarsikateri-Pi-mpa,-*-,premarsikateri-Pi-fsg,-*-,premarsikateri-Pi-fpn,-*-,premarsikateri-Pi-fpa
premarsikaterega	premarsikateri-Pi-msg,-*-,premarsikateri-Pi-msa,-*-,premarsikateri-Pi-nsg
premarsikaterem	premarsikateri-Pi-msl,-*-,premarsikateri-Pi-nsl
premarsikateremu	premarsikateri-Pi-msd,-*-,premarsikateri-Pi-nsd
premarsikateri	premarsikateri-Pi-msn,-*-,premarsikateri-Pi-msa,-*-,premarsikateri-Pi-mpn,-*-,premarsikateri-Pi-ndn,-*-,premarsikateri-Pi-nda,-*-,premarsikateri-Pi-fdn,-*-,premarsikateri-Pi-fda,-*-,premarsikateri-Pi-fsd,-*-,premarsikateri-Pi-fsl
premarsikaterih	premarsikateri-Pi-mdl,-*-,premarsikateri-Pi-mdg,-*-,premarsikateri-Pi-mpl,-*-,premarsikateri-Pi-mpg,-*-,premarsikateri-Pi-ndl,-*-,premarsikateri-Pi-ndg,-*-,premarsikateri-Pi-npl,-*-,premarsikateri-Pi-npg,-*-,premarsikateri-Pi-fdl,-*-,premarsikateri-Pi-fdg,-*-,premarsikateri-Pi-fpl,-*-,premarsikateri-Pi-fpg
premarsikaterim	premarsikateri-Pi-msi,-*-,premarsikateri-Pi-mpd,-*-,premarsikateri-Pi-nsi,-*-,premarsikateri-Pi-npd,-*-,premarsikateri-Pi-fpd
premarsikaterima	premarsikateri-Pi-mdd,-*-,premarsikateri-Pi-mdi,-*-,premarsikateri-Pi-ndd,-*-,premarsikateri-Pi-ndi,-*-,premarsikateri-Pi-fdd,-*-,premarsikateri-Pi-fdi
premarsikaterimi	premarsikateri-Pi-mpi,-*-,premarsikateri-Pi-npi,-*-,premarsikateri-Pi-fpi
premarsikatero	premarsikateri-Pi-nsn,-*-,premarsikateri-Pi-nsa,-*-,premarsikateri-Pi-fsi,-*-,premarsikateri-Pi-fsa
premnog	premnog-Pi-msn,-*-,premnog-Pi-msa
premnoga	premnog-Pi-mdn,-*-,premnog-Pi-mda,-*-,premnog-Pi-npn,-*-,premnog-Pi-npa,-*-,premnog-Pi-fsn
premnoge	premnog-Pi-mpa,-*-,premnog-Pi-fsg,-*-,premnog-Pi-fpn,-*-,premnog-Pi-fpa
premnogega	premnog-Pi-msg,-*-,premnog-Pi-msa,-*-,premnog-Pi-nsg
premnogem	premnog-Pi-msl,-*-,premnog-Pi-nsl
premnogemu	premnog-Pi-msd,-*-,premnog-Pi-nsd
premnogi	premnog-Pi-mpn,-*-,premnog-Pi-ndn,-*-,premnog-Pi-nda,-*-,premnog-Pi-fdn,-*-,premnog-Pi-fda,-*-,premnog-Pi-fsd,-*-,premnog-Pi-fsl
premnogih	premnog-Pi-mdl,-*-,premnog-Pi-mdg,-*-,premnog-Pi-mpl,-*-,premnog-Pi-mpg,-*-,premnog-Pi-ndl,-*-,premnog-Pi-ndg,-*-,premnog-Pi-npl,-*-,premnog-Pi-npg,-*-,premnog-Pi-fdl,-*-,premnog-Pi-fdg,-*-,premnog-Pi-fpl,-*-,premnog-Pi-fpg
premnogim	premnog-Pi-msi,-*-,premnog-Pi-mpd,-*-,premnog-Pi-nsi,-*-,premnog-Pi-npd,-*-,premnog-Pi-fpd
premnogima	premnog-Pi-mdd,-*-,premnog-Pi-mdi,-*-,premnog-Pi-ndd,-*-,premnog-Pi-ndi,-*-,premnog-Pi-fdd,-*-,premnog-Pi-fdi
premnogimi	premnog-Pi-mpi,-*-,premnog-Pi-npi,-*-,premnog-Pi-fpi
premnogo	premnog-Pi-nsn,-*-,premnog-Pi-nsa,-*-,premnog-Pi-fsi,-*-,premnog-Pi-fsa
prenekaj	prenekaj-Pi-nsn,-*-,prenekaj-Pi-nsa
prenekatera	prenekateri-Pi-mdn,-*-,prenekateri-Pi-mda,-*-,prenekateri-Pi-npn,-*-,prenekateri-Pi-npa,-*-,prenekateri-Pi-fsn
prenekatere	prenekateri-Pi-mpa,-*-,prenekateri-Pi-fsg,-*-,prenekateri-Pi-fpn,-*-,prenekateri-Pi-fpa
prenekaterega	prenekateri-Pi-msg,-*-,prenekateri-Pi-msa,-*-,prenekateri-Pi-nsg
prenekaterem	prenekateri-Pi-msl,-*-,prenekateri-Pi-nsl
prenekateremu	prenekateri-Pi-msd,-*-,prenekateri-Pi-nsd
prenekateri	prenekateri-Pi-msn,-*-,prenekateri-Pi-msa,-*-,prenekateri-Pi-mpn,-*-,prenekateri-Pi-ndn,-*-,prenekateri-Pi-nda,-*-,prenekateri-Pi-fdn,-*-,prenekateri-Pi-fda,-*-,prenekateri-Pi-fsd,-*-,prenekateri-Pi-fsl
prenekaterih	prenekateri-Pi-mdl,-*-,prenekateri-Pi-mdg,-*-,prenekateri-Pi-mpl,-*-,prenekateri-Pi-mpg,-*-,prenekateri-Pi-ndl,-*-,prenekateri-Pi-ndg,-*-,prenekateri-Pi-npl,-*-,prenekateri-Pi-npg,-*-,prenekateri-Pi-fdl,-*-,prenekateri-Pi-fdg,-*-,prenekateri-Pi-fpl,-*-,prenekateri-Pi-fpg
prenekaterim	prenekateri-Pi-msi,-*-,prenekateri-Pi-mpd,-*-,prenekateri-Pi-nsi,-*-,prenekateri-Pi-npd,-*-,prenekateri-Pi-fpd
prenekaterima	prenekateri-Pi-mdd,-*-,prenekateri-Pi-mdi,-*-,prenekateri-Pi-ndd,-*-,prenekateri-Pi-ndi,-*-,prenekateri-Pi-fdd,-*-,prenekateri-Pi-fdi
prenekaterimi	prenekateri-Pi-mpi,-*-,prenekateri-Pi-npi,-*-,prenekateri-Pi-fpi
prenekatero	prenekateri-Pi-nsn,-*-,prenekateri-Pi-nsa,-*-,prenekateri-Pi-fsi,-*-,prenekateri-Pi-fsa
prenekdo	prenekdo-Pi-msn
prenekoga	prenekdo-Pi-msg,-*-,prenekdo-Pi-msa
prenekom	prenekdo-Pi-msl,-*-,prenekdo-Pi-msi
prenekomu	prenekdo-Pi-msd
prenečem	prenekaj-Pi-nsl
prenečemu	prenekaj-Pi-nsd
prenečesa	prenekaj-Pi-nsg
prenečim	prenekaj-Pi-nsi
redkokatera	redkokateri-Pi-mdn,-*-,redkokateri-Pi-mda,-*-,redkokateri-Pi-npn,-*-,redkokateri-Pi-npa,-*-,redkokateri-Pi-fsn
redkokatere	redkokateri-Pi-mpa,-*-,redkokateri-Pi-fsg,-*-,redkokateri-Pi-fpn,-*-,redkokateri-Pi-fpa
redkokaterega	redkokateri-Pi-msg,-*-,redkokateri-Pi-msa,-*-,redkokateri-Pi-nsg
redkokaterem	redkokateri-Pi-msl,-*-,redkokateri-Pi-nsl
redkokateremu	redkokateri-Pi-msd,-*-,redkokateri-Pi-nsd
redkokateri	redkokateri-Pi-msn,-*-,redkokateri-Pi-msa,-*-,redkokateri-Pi-mpn,-*-,redkokateri-Pi-ndn,-*-,redkokateri-Pi-nda,-*-,redkokateri-Pi-fdn,-*-,redkokateri-Pi-fda,-*-,redkokateri-Pi-fsd,-*-,redkokateri-Pi-fsl
redkokaterih	redkokateri-Pi-mdl,-*-,redkokateri-Pi-mdg,-*-,redkokateri-Pi-mpl,-*-,redkokateri-Pi-mpg,-*-,redkokateri-Pi-ndl,-*-,redkokateri-Pi-ndg,-*-,redkokateri-Pi-npl,-*-,redkokateri-Pi-npg,-*-,redkokateri-Pi-fdl,-*-,redkokateri-Pi-fdg,-*-,redkokateri-Pi-fpl,-*-,redkokateri-Pi-fpg
redkokaterim	redkokateri-Pi-msi,-*-,redkokateri-Pi-mpd,-*-,redkokateri-Pi-nsi,-*-,redkokateri-Pi-npd,-*-,redkokateri-Pi-fpd
redkokaterima	redkokateri-Pi-mdd,-*-,redkokateri-Pi-mdi,-*-,redkokateri-Pi-ndd,-*-,redkokateri-Pi-ndi,-*-,redkokateri-Pi-fdd,-*-,redkokateri-Pi-fdi
redkokaterimi	redkokateri-Pi-mpi,-*-,redkokateri-Pi-npi,-*-,redkokateri-Pi-fpi
redkokatero	redkokateri-Pi-nsn,-*-,redkokateri-Pi-nsa,-*-,redkokateri-Pi-fsi,-*-,redkokateri-Pi-fsa
redkokdo	redkokdo-Pi-msn
redkokoga	redkokdo-Pi-msg,-*-,redkokdo-Pi-msa
redkokom	redkokdo-Pi-msl,-*-,redkokdo-Pi-msi
redkokomu	redkokdo-Pi-msd
sabo	se-Px---i
se	se-Px------y,-*-,se-Px------y
sebe	se-Px---g,-*-,se-Px---a
sebi	se-Px---d,-*-,se-Px---l
seboj	se-Px---i
si	se-Px---d--y
skozenj	skozme-Pp3msa--b,-*-,skozme-Pp3nsa--b
skozme	skozme-Pp1-sa--b
skoznje	skozme-Pp3mpa--b,-*-,skozme-Pp3npa--b,-*-,skozme-Pp3fpa--b
skoznjo	skozme-Pp3fsa--b
skoznju	skozme-Pp3mda--b,-*-,skozme-Pp3nda--b,-*-,skozme-Pp3fda--b
skozse	skozse-Px---a--b
skozte	skozme-Pp2-sa--b
svoj	svoj-Px-msn,-*-,svoj-Px-msa
svoja	svoj-Px-mdn,-*-,svoj-Px-mda,-*-,svoj-Px-npn,-*-,svoj-Px-npa,-*-,svoj-Px-fsn
svoje	svoj-Px-mpa,-*-,svoj-Px-nsn,-*-,svoj-Px-nsa,-*-,svoj-Px-fsg,-*-,svoj-Px-fpn,-*-,svoj-Px-fpa
svojega	svoj-Px-msg,-*-,svoj-Px-msa,-*-,svoj-Px-nsg
svojem	svoj-Px-msl,-*-,svoj-Px-nsl
svojemu	svoj-Px-msd,-*-,svoj-Px-nsd
svoji	svoj-Px-mpn,-*-,svoj-Px-ndn,-*-,svoj-Px-nda,-*-,svoj-Px-fdn,-*-,svoj-Px-fda,-*-,svoj-Px-fsd,-*-,svoj-Px-fsl
svojih	svoj-Px-mdl,-*-,svoj-Px-mdg,-*-,svoj-Px-mpl,-*-,svoj-Px-mpg,-*-,svoj-Px-ndl,-*-,svoj-Px-ndg,-*-,svoj-Px-npl,-*-,svoj-Px-npg,-*-,svoj-Px-fdl,-*-,svoj-Px-fdg,-*-,svoj-Px-fpl,-*-,svoj-Px-fpg
svojim	svoj-Px-msi,-*-,svoj-Px-mpd,-*-,svoj-Px-nsi,-*-,svoj-Px-npd,-*-,svoj-Px-fpd
svojima	svoj-Px-mdd,-*-,svoj-Px-mdi,-*-,svoj-Px-ndd,-*-,svoj-Px-ndi,-*-,svoj-Px-fdd,-*-,svoj-Px-fdi
svojimi	svoj-Px-mpi,-*-,svoj-Px-npi,-*-,svoj-Px-fpi
svojo	svoj-Px-fsi,-*-,svoj-Px-fsa
ta	ta-Pd-mdn,-*-,ta-Pd-mda,-*-,ta-Pd-msn,-*-,ta-Pd-msa,-*-,ta-Pd-npn,-*-,ta-Pd-npa,-*-,ta-Pd-fsn
tabo	ti-Pp2-si
tadva	tadva-Pd-mdn,-*-,tadva-Pd-mda
taista	taisti-Pd-mdn,-*-,taisti-Pd-mda,-*-,taisti-Pd-npn,-*-,taisti-Pd-npa,-*-,taisti-Pd-fsn
taiste	taisti-Pd-mpa,-*-,taisti-Pd-fsg,-*-,taisti-Pd-fpn,-*-,taisti-Pd-fpa
taistega	taisti-Pd-msg,-*-,taisti-Pd-msa,-*-,taisti-Pd-nsg
taistem	taisti-Pd-msl,-*-,taisti-Pd-nsl
taistemu	taisti-Pd-msd,-*-,taisti-Pd-nsd
taisti	taisti-Pd-msn,-*-,taisti-Pd-msa,-*-,taisti-Pd-mpn,-*-,taisti-Pd-ndn,-*-,taisti-Pd-nda,-*-,taisti-Pd-fdn,-*-,taisti-Pd-fda,-*-,taisti-Pd-fsd,-*-,taisti-Pd-fsl
taistih	taisti-Pd-mdl,-*-,taisti-Pd-mdg,-*-,taisti-Pd-mpl,-*-,taisti-Pd-mpg,-*-,taisti-Pd-ndl,-*-,taisti-Pd-ndg,-*-,taisti-Pd-npl,-*-,taisti-Pd-npg,-*-,taisti-Pd-fdl,-*-,taisti-Pd-fdg,-*-,taisti-Pd-fpl,-*-,taisti-Pd-fpg
taistim	taisti-Pd-msi,-*-,taisti-Pd-mpd,-*-,taisti-Pd-nsi,-*-,taisti-Pd-npd,-*-,taisti-Pd-fpd
taistima	taisti-Pd-mdd,-*-,taisti-Pd-mdi,-*-,taisti-Pd-ndd,-*-,taisti-Pd-ndi,-*-,taisti-Pd-fdd,-*-,taisti-Pd-fdi
taistimi	taisti-Pd-mpi,-*-,taisti-Pd-npi,-*-,taisti-Pd-fpi
taisto	taisti-Pd-nsn,-*-,taisti-Pd-nsa,-*-,taisti-Pd-fsi,-*-,taisti-Pd-fsa
tak	tak-Pd-msn,-*-,tak-Pd-msa
taka	tak-Pd-mdn,-*-,tak-Pd-mda,-*-,tak-Pd-npn,-*-,tak-Pd-npa,-*-,tak-Pd-fsn
takale	takle-Pd-mdn,-*-,takle-Pd-mda,-*-,takle-Pd-npn,-*-,takle-Pd-npa,-*-,takle-Pd-fsn
take	tak-Pd-mpa,-*-,tak-Pd-fsg,-*-,tak-Pd-fpn,-*-,tak-Pd-fpa
takega	tak-Pd-msg,-*-,tak-Pd-msa,-*-,tak-Pd-nsg
takegale	takle-Pd-msg,-*-,takle-Pd-msa,-*-,takle-Pd-nsg
takele	takle-Pd-mpa,-*-,takle-Pd-fsg,-*-,takle-Pd-fpn,-*-,takle-Pd-fpa
takem	tak-Pd-msl,-*-,tak-Pd-nsl
takemle	takle-Pd-msl,-*-,takle-Pd-nsl
takemu	tak-Pd-msd,-*-,tak-Pd-nsd
takemule	takle-Pd-msd,-*-,takle-Pd-nsd
taki	tak-Pd-mpn,-*-,tak-Pd-ndn,-*-,tak-Pd-nda,-*-,tak-Pd-fdn,-*-,tak-Pd-fda,-*-,tak-Pd-fsd,-*-,tak-Pd-fsl
takih	tak-Pd-mdl,-*-,tak-Pd-mdg,-*-,tak-Pd-mpl,-*-,tak-Pd-mpg,-*-,tak-Pd-ndl,-*-,tak-Pd-ndg,-*-,tak-Pd-npl,-*-,tak-Pd-npg,-*-,tak-Pd-fdl,-*-,tak-Pd-fdg,-*-,tak-Pd-fpl,-*-,tak-Pd-fpg
takihle	takle-Pd-mdl,-*-,takle-Pd-mdg,-*-,takle-Pd-mpl,-*-,takle-Pd-mpg,-*-,takle-Pd-ndl,-*-,takle-Pd-ndg,-*-,takle-Pd-npl,-*-,takle-Pd-npg,-*-,takle-Pd-fdl,-*-,takle-Pd-fdg,-*-,takle-Pd-fpl,-*-,takle-Pd-fpg
takile	takle-Pd-mpn,-*-,takle-Pd-ndn,-*-,takle-Pd-nda,-*-,takle-Pd-fdn,-*-,takle-Pd-fda,-*-,takle-Pd-fsd,-*-,takle-Pd-fsl
takim	tak-Pd-msi,-*-,tak-Pd-mpd,-*-,tak-Pd-nsi,-*-,tak-Pd-npd,-*-,tak-Pd-fpd
takima	tak-Pd-mdd,-*-,tak-Pd-mdi,-*-,tak-Pd-ndd,-*-,tak-Pd-ndi,-*-,tak-Pd-fdd,-*-,tak-Pd-fdi
takimale	takle-Pd-mdd,-*-,takle-Pd-mdi,-*-,takle-Pd-ndd,-*-,takle-Pd-ndi,-*-,takle-Pd-fdd,-*-,takle-Pd-fdi
takimi	tak-Pd-mpi,-*-,tak-Pd-npi,-*-,tak-Pd-fpi
takimile	takle-Pd-mpi,-*-,takle-Pd-npi,-*-,takle-Pd-fpi
takimle	takle-Pd-msi,-*-,takle-Pd-mpd,-*-,takle-Pd-nsi,-*-,takle-Pd-npd,-*-,takle-Pd-fpd
takista	takisti-Pd-mdn,-*-,takisti-Pd-mda,-*-,takisti-Pd-npn,-*-,takisti-Pd-npa,-*-,takisti-Pd-fsn
takiste	takisti-Pd-mpa,-*-,takisti-Pd-fsg,-*-,takisti-Pd-fpn,-*-,takisti-Pd-fpa
takistega	takisti-Pd-msg,-*-,takisti-Pd-msa,-*-,takisti-Pd-nsg
takistem	takisti-Pd-msl,-*-,takisti-Pd-nsl
takistemu	takisti-Pd-msd,-*-,takisti-Pd-nsd
takisti	takisti-Pd-msn,-*-,takisti-Pd-msa,-*-,takisti-Pd-mpn,-*-,takisti-Pd-ndn,-*-,takisti-Pd-nda,-*-,takisti-Pd-fdn,-*-,takisti-Pd-fda,-*-,takisti-Pd-fsd,-*-,takisti-Pd-fsl
takistih	takisti-Pd-mdl,-*-,takisti-Pd-mdg,-*-,takisti-Pd-mpl,-*-,takisti-Pd-mpg,-*-,takisti-Pd-ndl,-*-,takisti-Pd-ndg,-*-,takisti-Pd-npl,-*-,takisti-Pd-npg,-*-,takisti-Pd-fdl,-*-,takisti-Pd-fdg,-*-,takisti-Pd-fpl,-*-,takisti-Pd-fpg
takistim	takisti-Pd-msi,-*-,takisti-Pd-mpd,-*-,takisti-Pd-nsi,-*-,takisti-Pd-npd,-*-,takisti-Pd-fpd
takistima	takisti-Pd-mdd,-*-,takisti-Pd-mdi,-*-,takisti-Pd-ndd,-*-,takisti-Pd-ndi,-*-,takisti-Pd-fdd,-*-,takisti-Pd-fdi
takistimi	takisti-Pd-mpi,-*-,takisti-Pd-npi,-*-,takisti-Pd-fpi
takisto	takisti-Pd-nsn,-*-,takisti-Pd-nsa,-*-,takisti-Pd-fsi,-*-,takisti-Pd-fsa
takle	takle-Pd-msn,-*-,takle-Pd-msa
tako	tak-Pd-nsn,-*-,tak-Pd-nsa,-*-,tak-Pd-fsi,-*-,tak-Pd-fsa
takole	takle-Pd-nsn,-*-,takle-Pd-nsa,-*-,takle-Pd-fsi,-*-,takle-Pd-fsa
takov	takov-Pd-msn,-*-,takov-Pd-msa
takova	takov-Pd-mdn,-*-,takov-Pd-mda,-*-,takov-Pd-npn,-*-,takov-Pd-npa,-*-,takov-Pd-fsn
takove	takov-Pd-mpa,-*-,takov-Pd-fsg,-*-,takov-Pd-fpn,-*-,takov-Pd-fpa
takovega	takov-Pd-msg,-*-,takov-Pd-msa,-*-,takov-Pd-nsg
takovem	takov-Pd-msl,-*-,takov-Pd-nsl
takovemu	takov-Pd-msd,-*-,takov-Pd-nsd
takovi	takov-Pd-mpn,-*-,takov-Pd-ndn,-*-,takov-Pd-nda,-*-,takov-Pd-fdn,-*-,takov-Pd-fda,-*-,takov-Pd-fsd,-*-,takov-Pd-fsl
takovih	takov-Pd-mdl,-*-,takov-Pd-mdg,-*-,takov-Pd-mpl,-*-,takov-Pd-mpg,-*-,takov-Pd-ndl,-*-,takov-Pd-ndg,-*-,takov-Pd-npl,-*-,takov-Pd-npg,-*-,takov-Pd-fdl,-*-,takov-Pd-fdg,-*-,takov-Pd-fpl,-*-,takov-Pd-fpg
takovim	takov-Pd-msi,-*-,takov-Pd-mpd,-*-,takov-Pd-nsi,-*-,takov-Pd-npd,-*-,takov-Pd-fpd
takovima	takov-Pd-mdd,-*-,takov-Pd-mdi,-*-,takov-Pd-ndd,-*-,takov-Pd-ndi,-*-,takov-Pd-fdd,-*-,takov-Pd-fdi
takovimi	takov-Pd-mpi,-*-,takov-Pd-npi,-*-,takov-Pd-fpi
takovo	takov-Pd-nsn,-*-,takov-Pd-nsa,-*-,takov-Pd-fsi,-*-,takov-Pd-fsa
takošen	takošen-Pd-msn,-*-,takošen-Pd-msa
takošna	takošen-Pd-mdn,-*-,takošen-Pd-mda,-*-,takošen-Pd-npn,-*-,takošen-Pd-npa,-*-,takošen-Pd-fsn
takošne	takošen-Pd-mpa,-*-,takošen-Pd-fsg,-*-,takošen-Pd-fpn,-*-,takošen-Pd-fpa
takošnega	takošen-Pd-msg,-*-,takošen-Pd-msa,-*-,takošen-Pd-nsg
takošnem	takošen-Pd-msl,-*-,takošen-Pd-nsl
takošnemu	takošen-Pd-msd,-*-,takošen-Pd-nsd
takošni	takošen-Pd-mpn,-*-,takošen-Pd-ndn,-*-,takošen-Pd-nda,-*-,takošen-Pd-fdn,-*-,takošen-Pd-fda,-*-,takošen-Pd-fsd,-*-,takošen-Pd-fsl
takošnih	takošen-Pd-mdl,-*-,takošen-Pd-mdg,-*-,takošen-Pd-mpl,-*-,takošen-Pd-mpg,-*-,takošen-Pd-ndl,-*-,takošen-Pd-ndg,-*-,takošen-Pd-npl,-*-,takošen-Pd-npg,-*-,takošen-Pd-fdl,-*-,takošen-Pd-fdg,-*-,takošen-Pd-fpl,-*-,takošen-Pd-fpg
takošnim	takošen-Pd-msi,-*-,takošen-Pd-mpd,-*-,takošen-Pd-nsi,-*-,takošen-Pd-npd,-*-,takošen-Pd-fpd
takošnima	takošen-Pd-mdd,-*-,takošen-Pd-mdi,-*-,takošen-Pd-ndd,-*-,takošen-Pd-ndi,-*-,takošen-Pd-fdd,-*-,takošen-Pd-fdi
takošnimi	takošen-Pd-mpi,-*-,takošen-Pd-npi,-*-,takošen-Pd-fpi
takošno	takošen-Pd-nsn,-*-,takošen-Pd-nsa,-*-,takošen-Pd-fsi,-*-,takošen-Pd-fsa
takšen	takšen-Pd-msn,-*-,takšen-Pd-msa
takšenle	takšenle-Pd-msn,-*-,takšenle-Pd-msa
takšna	takšen-Pd-mdn,-*-,takšen-Pd-mda,-*-,takšen-Pd-npn,-*-,takšen-Pd-npa,-*-,takšen-Pd-fsn
takšnale	takšenle-Pd-mdn,-*-,takšenle-Pd-mda,-*-,takšenle-Pd-npn,-*-,takšenle-Pd-npa,-*-,takšenle-Pd-fsn
takšne	takšen-Pd-mpa,-*-,takšen-Pd-fsg,-*-,takšen-Pd-fpn,-*-,takšen-Pd-fpa
takšnega	takšen-Pd-msg,-*-,takšen-Pd-msa,-*-,takšen-Pd-nsg
takšnegale	takšenle-Pd-msg,-*-,takšenle-Pd-msa,-*-,takšenle-Pd-nsg
takšnele	takšenle-Pd-mpa,-*-,takšenle-Pd-fsg,-*-,takšenle-Pd-fpn,-*-,takšenle-Pd-fpa
takšnem	takšen-Pd-msl,-*-,takšen-Pd-nsl
takšnemle	takšenle-Pd-msl,-*-,takšenle-Pd-nsl
takšnemu	takšen-Pd-msd,-*-,takšen-Pd-nsd
takšnemule	takšenle-Pd-msd,-*-,takšenle-Pd-nsd
takšni	takšen-Pd-mpn,-*-,takšen-Pd-ndn,-*-,takšen-Pd-nda,-*-,takšen-Pd-fdn,-*-,takšen-Pd-fda,-*-,takšen-Pd-fsd,-*-,takšen-Pd-fsl
takšnih	takšen-Pd-mdl,-*-,takšen-Pd-mdg,-*-,takšen-Pd-mpl,-*-,takšen-Pd-mpg,-*-,takšen-Pd-ndl,-*-,takšen-Pd-ndg,-*-,takšen-Pd-npl,-*-,takšen-Pd-npg,-*-,takšen-Pd-fdl,-*-,takšen-Pd-fdg,-*-,takšen-Pd-fpl,-*-,takšen-Pd-fpg
takšnihle	takšenle-Pd-mdl,-*-,takšenle-Pd-mdg,-*-,takšenle-Pd-mpl,-*-,takšenle-Pd-mpg,-*-,takšenle-Pd-ndl,-*-,takšenle-Pd-ndg,-*-,takšenle-Pd-npl,-*-,takšenle-Pd-npg,-*-,takšenle-Pd-fdl,-*-,takšenle-Pd-fdg,-*-,takšenle-Pd-fpl,-*-,takšenle-Pd-fpg
takšnile	takšenle-Pd-mpn,-*-,takšenle-Pd-ndn,-*-,takšenle-Pd-nda,-*-,takšenle-Pd-fdn,-*-,takšenle-Pd-fda,-*-,takšenle-Pd-fsd,-*-,takšenle-Pd-fsl
takšnim	takšen-Pd-msi,-*-,takšen-Pd-mpd,-*-,takšen-Pd-nsi,-*-,takšen-Pd-npd,-*-,takšen-Pd-fpd
takšnima	takšen-Pd-mdd,-*-,takšen-Pd-mdi,-*-,takšen-Pd-ndd,-*-,takšen-Pd-ndi,-*-,takšen-Pd-fdd,-*-,takšen-Pd-fdi
takšnimale	takšenle-Pd-mdd,-*-,takšenle-Pd-mdi,-*-,takšenle-Pd-ndd,-*-,takšenle-Pd-ndi,-*-,takšenle-Pd-fdd,-*-,takšenle-Pd-fdi
takšnimi	takšen-Pd-mpi,-*-,takšen-Pd-npi,-*-,takšen-Pd-fpi
takšnimile	takšenle-Pd-mpi,-*-,takšenle-Pd-npi,-*-,takšenle-Pd-fpi
takšnimle	takšenle-Pd-msi,-*-,takšenle-Pd-mpd,-*-,takšenle-Pd-nsi,-*-,takšenle-Pd-npd,-*-,takšenle-Pd-fpd
takšno	takšen-Pd-nsn,-*-,takšen-Pd-nsa,-*-,takšen-Pd-fsi,-*-,takšen-Pd-fsa
takšnole	takšenle-Pd-nsn,-*-,takšenle-Pd-nsa,-*-,takšenle-Pd-fsi,-*-,takšenle-Pd-fsa
tale	tale-Pd-mdn,-*-,tale-Pd-mda,-*-,tale-Pd-msn,-*-,tale-Pd-msa,-*-,tale-Pd-npn,-*-,tale-Pd-npa,-*-,tale-Pd-fsn
talele	talele-Pd-mdn,-*-,talele-Pd-mda,-*-,talele-Pd-msn,-*-,talele-Pd-msa,-*-,talele-Pd-npn,-*-,talele-Pd-npa,-*-,talele-Pd-fsn
te	ta-Pd-mpa,-*-,ta-Pd-ndn,-*-,ta-Pd-nda,-*-,ta-Pd-fdn,-*-,ta-Pd-fda,-*-,ta-Pd-fsg,-*-,ta-Pd-fpn,-*-,ta-Pd-fpa,-*-,ti-Pp2-sg--y,-*-,ti-Pp2-sa--y
tebe	ti-Pp2-sg,-*-,ti-Pp2-sa
tebi	ti-Pp2-sd,-*-,ti-Pp2-sl
teboj	ti-Pp2-si
tega	ta-Pd-msg,-*-,ta-Pd-msa,-*-,ta-Pd-nsg
tegale	tale-Pd-msg,-*-,tale-Pd-msa,-*-,tale-Pd-nsg
tegalele	talele-Pd-msg,-*-,talele-Pd-msa,-*-,talele-Pd-nsg
teh	ta-Pd-mdl,-*-,ta-Pd-mdg,-*-,ta-Pd-mpl,-*-,ta-Pd-mpg,-*-,ta-Pd-ndl,-*-,ta-Pd-ndg,-*-,ta-Pd-npl,-*-,ta-Pd-npg,-*-,ta-Pd-fdl,-*-,ta-Pd-fdg,-*-,ta-Pd-fpl,-*-,ta-Pd-fpg
tehle	tale-Pd-mdl,-*-,tale-Pd-mdg,-*-,tale-Pd-mpl,-*-,tale-Pd-mpg,-*-,tale-Pd-ndl,-*-,tale-Pd-ndg,-*-,tale-Pd-npl,-*-,tale-Pd-npg,-*-,tale-Pd-fdl,-*-,tale-Pd-fdg,-*-,tale-Pd-fpl,-*-,tale-Pd-fpg
tehlele	talele-Pd-mdl,-*-,talele-Pd-mdg,-*-,talele-Pd-mpl,-*-,talele-Pd-mpg,-*-,talele-Pd-ndl,-*-,talele-Pd-ndg,-*-,talele-Pd-npl,-*-,talele-Pd-npg,-*-,talele-Pd-fdl,-*-,talele-Pd-fdg,-*-,talele-Pd-fpl,-*-,talele-Pd-fpg
tej	ta-Pd-fsd,-*-,ta-Pd-fsl
tejle	tale-Pd-fsd,-*-,tale-Pd-fsl
tejlele	talele-Pd-fsd,-*-,talele-Pd-fsl
tele	tale-Pd-mpa,-*-,tale-Pd-ndn,-*-,tale-Pd-nda,-*-,tale-Pd-fdn,-*-,tale-Pd-fda,-*-,tale-Pd-fsg,-*-,tale-Pd-fpn,-*-,tale-Pd-fpa
telele	talele-Pd-mpa,-*-,talele-Pd-ndn,-*-,talele-Pd-nda,-*-,talele-Pd-fdn,-*-,talele-Pd-fda,-*-,talele-Pd-fsg,-*-,talele-Pd-fpn,-*-,talele-Pd-fpa
tem	ta-Pd-msl,-*-,ta-Pd-msi,-*-,ta-Pd-mpd,-*-,ta-Pd-nsl,-*-,ta-Pd-nsi,-*-,ta-Pd-npd,-*-,ta-Pd-fpd
tema	ta-Pd-mdd,-*-,ta-Pd-mdi,-*-,ta-Pd-ndd,-*-,ta-Pd-ndi,-*-,ta-Pd-fdd,-*-,ta-Pd-fdi
temale	tale-Pd-mdd,-*-,tale-Pd-mdi,-*-,tale-Pd-ndd,-*-,tale-Pd-ndi,-*-,tale-Pd-fdd,-*-,tale-Pd-fdi
temalele	talele-Pd-mdd,-*-,talele-Pd-mdi,-*-,talele-Pd-ndd,-*-,talele-Pd-ndi,-*-,talele-Pd-fdd,-*-,talele-Pd-fdi
temi	ta-Pd-mpi,-*-,ta-Pd-npi,-*-,ta-Pd-fpi
temile	tale-Pd-mpi,-*-,tale-Pd-npi,-*-,tale-Pd-fpi
temilele	talele-Pd-mpi,-*-,talele-Pd-npi,-*-,talele-Pd-fpi
temle	tale-Pd-msl,-*-,tale-Pd-msi,-*-,tale-Pd-mpd,-*-,tale-Pd-nsl,-*-,tale-Pd-nsi,-*-,tale-Pd-npd,-*-,tale-Pd-fpd
temlele	talele-Pd-msl,-*-,talele-Pd-msi,-*-,talele-Pd-mpd,-*-,talele-Pd-nsl,-*-,talele-Pd-nsi,-*-,talele-Pd-npd,-*-,talele-Pd-fpd
temu	ta-Pd-msd,-*-,ta-Pd-nsd
temule	tale-Pd-msd,-*-,tale-Pd-nsd
temulele	talele-Pd-msd,-*-,talele-Pd-nsd
ti	ta-Pd-mpn,-*-,ta-Pd-ndn,-*-,ta-Pd-nda,-*-,ta-Pd-fdn,-*-,ta-Pd-fda,-*-,ti-Pp2-sd--y,-*-,ti-Pp2-sn
tile	tale-Pd-mpn,-*-,tale-Pd-ndn,-*-,tale-Pd-nda,-*-,tale-Pd-fdn,-*-,tale-Pd-fda
tilele	talele-Pd-mpn,-*-,talele-Pd-ndn,-*-,talele-Pd-nda,-*-,talele-Pd-fdn,-*-,talele-Pd-fda
tista	tisti-Pd-mdn,-*-,tisti-Pd-mda,-*-,tisti-Pd-npn,-*-,tisti-Pd-npa,-*-,tisti-Pd-fsn
tistale	tistile-Pd-mdn,-*-,tistile-Pd-mda,-*-,tistile-Pd-npn,-*-,tistile-Pd-npa,-*-,tistile-Pd-fsn
tiste	tisti-Pd-mpa,-*-,tisti-Pd-fsg,-*-,tisti-Pd-fpn,-*-,tisti-Pd-fpa
tistega	tisti-Pd-msg,-*-,tisti-Pd-msa,-*-,tisti-Pd-nsg
tistegale	tistile-Pd-msg,-*-,tistile-Pd-msa,-*-,tistile-Pd-nsg
tistele	tistile-Pd-mpa,-*-,tistile-Pd-fsg,-*-,tistile-Pd-fpn,-*-,tistile-Pd-fpa
tistem	tisti-Pd-msl,-*-,tisti-Pd-nsl
tistemle	tistile-Pd-msl,-*-,tistile-Pd-nsl
tistemu	tisti-Pd-msd,-*-,tisti-Pd-nsd
tistemule	tistile-Pd-msd,-*-,tistile-Pd-nsd
tisti	tisti-Pd-msn,-*-,tisti-Pd-msa,-*-,tisti-Pd-mpn,-*-,tisti-Pd-ndn,-*-,tisti-Pd-nda,-*-,tisti-Pd-fdn,-*-,tisti-Pd-fda,-*-,tisti-Pd-fsd,-*-,tisti-Pd-fsl
tistih	tisti-Pd-mdl,-*-,tisti-Pd-mdg,-*-,tisti-Pd-mpl,-*-,tisti-Pd-mpg,-*-,tisti-Pd-ndl,-*-,tisti-Pd-ndg,-*-,tisti-Pd-npl,-*-,tisti-Pd-npg,-*-,tisti-Pd-fdl,-*-,tisti-Pd-fdg,-*-,tisti-Pd-fpl,-*-,tisti-Pd-fpg
tistihle	tistile-Pd-mdl,-*-,tistile-Pd-mdg,-*-,tistile-Pd-mpl,-*-,tistile-Pd-mpg,-*-,tistile-Pd-ndl,-*-,tistile-Pd-ndg,-*-,tistile-Pd-npl,-*-,tistile-Pd-npg,-*-,tistile-Pd-fdl,-*-,tistile-Pd-fdg,-*-,tistile-Pd-fpl,-*-,tistile-Pd-fpg
tistile	tistile-Pd-msn,-*-,tistile-Pd-msa,-*-,tistile-Pd-mpn,-*-,tistile-Pd-ndn,-*-,tistile-Pd-nda,-*-,tistile-Pd-fdn,-*-,tistile-Pd-fda,-*-,tistile-Pd-fsd,-*-,tistile-Pd-fsl
tistim	tisti-Pd-msi,-*-,tisti-Pd-mpd,-*-,tisti-Pd-nsi,-*-,tisti-Pd-npd,-*-,tisti-Pd-fpd
tistima	tisti-Pd-mdd,-*-,tisti-Pd-mdi,-*-,tisti-Pd-ndd,-*-,tisti-Pd-ndi,-*-,tisti-Pd-fdd,-*-,tisti-Pd-fdi
tistimale	tistile-Pd-mdd,-*-,tistile-Pd-mdi,-*-,tistile-Pd-ndd,-*-,tistile-Pd-ndi,-*-,tistile-Pd-fdd,-*-,tistile-Pd-fdi
tistimi	tisti-Pd-mpi,-*-,tisti-Pd-npi,-*-,tisti-Pd-fpi
tistimile	tistile-Pd-mpi,-*-,tistile-Pd-npi,-*-,tistile-Pd-fpi
tistimle	tistile-Pd-msi,-*-,tistile-Pd-mpd,-*-,tistile-Pd-nsi,-*-,tistile-Pd-npd,-*-,tistile-Pd-fpd
tisto	tisti-Pd-nsn,-*-,tisti-Pd-nsa,-*-,tisti-Pd-fsi,-*-,tisti-Pd-fsa
tistole	tistile-Pd-nsn,-*-,tistile-Pd-nsa,-*-,tistile-Pd-fsi,-*-,tistile-Pd-fsa
to	ta-Pd-nsn,-*-,ta-Pd-nsa,-*-,ta-Pd-fsi,-*-,ta-Pd-fsa
tole	tale-Pd-nsn,-*-,tale-Pd-nsa,-*-,tale-Pd-fsi,-*-,tale-Pd-fsa
tolele	talele-Pd-nsn,-*-,talele-Pd-nsa,-*-,talele-Pd-fsi,-*-,talele-Pd-fsa
tolik	tolik-Pd-msn,-*-,tolik-Pd-msa
tolika	tolik-Pd-mdn,-*-,tolik-Pd-mda,-*-,tolik-Pd-npn,-*-,tolik-Pd-npa,-*-,tolik-Pd-fsn
tolike	tolik-Pd-mpa,-*-,tolik-Pd-fsg,-*-,tolik-Pd-fpn,-*-,tolik-Pd-fpa
tolikega	tolik-Pd-msg,-*-,tolik-Pd-msa,-*-,tolik-Pd-nsg
tolikem	tolik-Pd-msl,-*-,tolik-Pd-nsl
tolikemu	tolik-Pd-msd,-*-,tolik-Pd-nsd
toliker	toliker-Pd-msn,-*-,toliker-Pd-msa
tolikera	toliker-Pd-mdn,-*-,toliker-Pd-mda,-*-,toliker-Pd-npn,-*-,toliker-Pd-npa,-*-,toliker-Pd-fsn
tolikere	toliker-Pd-mpa,-*-,toliker-Pd-fsg,-*-,toliker-Pd-fpn,-*-,toliker-Pd-fpa
tolikerega	toliker-Pd-msg,-*-,toliker-Pd-msa,-*-,toliker-Pd-nsg
tolikerem	toliker-Pd-msl,-*-,toliker-Pd-nsl
tolikeremu	toliker-Pd-msd,-*-,toliker-Pd-nsd
tolikeri	toliker-Pd-mpn,-*-,toliker-Pd-ndn,-*-,toliker-Pd-nda,-*-,toliker-Pd-fdn,-*-,toliker-Pd-fda,-*-,toliker-Pd-fsd,-*-,toliker-Pd-fsl
tolikerih	toliker-Pd-mdl,-*-,toliker-Pd-mdg,-*-,toliker-Pd-mpl,-*-,toliker-Pd-mpg,-*-,toliker-Pd-ndl,-*-,toliker-Pd-ndg,-*-,toliker-Pd-npl,-*-,toliker-Pd-npg,-*-,toliker-Pd-fdl,-*-,toliker-Pd-fdg,-*-,toliker-Pd-fpl,-*-,toliker-Pd-fpg
tolikerim	toliker-Pd-msi,-*-,toliker-Pd-mpd,-*-,toliker-Pd-nsi,-*-,toliker-Pd-npd,-*-,toliker-Pd-fpd
tolikerima	toliker-Pd-mdd,-*-,toliker-Pd-mdi,-*-,toliker-Pd-ndd,-*-,toliker-Pd-ndi,-*-,toliker-Pd-fdd,-*-,toliker-Pd-fdi
tolikerimi	toliker-Pd-mpi,-*-,toliker-Pd-npi,-*-,toliker-Pd-fpi
tolikero	toliker-Pd-nsn,-*-,toliker-Pd-nsa,-*-,toliker-Pd-fsi,-*-,toliker-Pd-fsa
toliki	tolik-Pd-mpn,-*-,tolik-Pd-ndn,-*-,tolik-Pd-nda,-*-,tolik-Pd-fdn,-*-,tolik-Pd-fda,-*-,tolik-Pd-fsd,-*-,tolik-Pd-fsl
tolikih	tolik-Pd-mdl,-*-,tolik-Pd-mdg,-*-,tolik-Pd-mpl,-*-,tolik-Pd-mpg,-*-,tolik-Pd-ndl,-*-,tolik-Pd-ndg,-*-,tolik-Pd-npl,-*-,tolik-Pd-npg,-*-,tolik-Pd-fdl,-*-,tolik-Pd-fdg,-*-,tolik-Pd-fpl,-*-,tolik-Pd-fpg
tolikim	tolik-Pd-msi,-*-,tolik-Pd-mpd,-*-,tolik-Pd-nsi,-*-,tolik-Pd-npd,-*-,tolik-Pd-fpd
tolikima	tolik-Pd-mdd,-*-,tolik-Pd-mdi,-*-,tolik-Pd-ndd,-*-,tolik-Pd-ndi,-*-,tolik-Pd-fdd,-*-,tolik-Pd-fdi
tolikimi	tolik-Pd-mpi,-*-,tolik-Pd-npi,-*-,tolik-Pd-fpi
toliko	tolik-Pd-nsn,-*-,tolik-Pd-nsa,-*-,tolik-Pd-fsi,-*-,tolik-Pd-fsa
tolikšen	tolikšen-Pd-msn,-*-,tolikšen-Pd-msa
tolikšna	tolikšen-Pd-mdn,-*-,tolikšen-Pd-mda,-*-,tolikšen-Pd-npn,-*-,tolikšen-Pd-npa,-*-,tolikšen-Pd-fsn
tolikšne	tolikšen-Pd-mpa,-*-,tolikšen-Pd-fsg,-*-,tolikšen-Pd-fpn,-*-,tolikšen-Pd-fpa
tolikšnega	tolikšen-Pd-msg,-*-,tolikšen-Pd-msa,-*-,tolikšen-Pd-nsg
tolikšnem	tolikšen-Pd-msl,-*-,tolikšen-Pd-nsl
tolikšnemu	tolikšen-Pd-msd,-*-,tolikšen-Pd-nsd
tolikšni	tolikšen-Pd-mpn,-*-,tolikšen-Pd-ndn,-*-,tolikšen-Pd-nda,-*-,tolikšen-Pd-fdn,-*-,tolikšen-Pd-fda,-*-,tolikšen-Pd-fsd,-*-,tolikšen-Pd-fsl
tolikšnih	tolikšen-Pd-mdl,-*-,tolikšen-Pd-mdg,-*-,tolikšen-Pd-mpl,-*-,tolikšen-Pd-mpg,-*-,tolikšen-Pd-ndl,-*-,tolikšen-Pd-ndg,-*-,tolikšen-Pd-npl,-*-,tolikšen-Pd-npg,-*-,tolikšen-Pd-fdl,-*-,tolikšen-Pd-fdg,-*-,tolikšen-Pd-fpl,-*-,tolikšen-Pd-fpg
tolikšnim	tolikšen-Pd-msi,-*-,tolikšen-Pd-mpd,-*-,tolikšen-Pd-nsi,-*-,tolikšen-Pd-npd,-*-,tolikšen-Pd-fpd
tolikšnima	tolikšen-Pd-mdd,-*-,tolikšen-Pd-mdi,-*-,tolikšen-Pd-ndd,-*-,tolikšen-Pd-ndi,-*-,tolikšen-Pd-fdd,-*-,tolikšen-Pd-fdi
tolikšnimi	tolikšen-Pd-mpi,-*-,tolikšen-Pd-npi,-*-,tolikšen-Pd-fpi
tolikšnja	tolikšnji-Pd-mdn,-*-,tolikšnji-Pd-mda,-*-,tolikšnji-Pd-npn,-*-,tolikšnji-Pd-npa,-*-,tolikšnji-Pd-fsn
tolikšnje	tolikšnji-Pd-mpa,-*-,tolikšnji-Pd-nsn,-*-,tolikšnji-Pd-nsa,-*-,tolikšnji-Pd-fsg,-*-,tolikšnji-Pd-fpn,-*-,tolikšnji-Pd-fpa
tolikšnjega	tolikšnji-Pd-msg,-*-,tolikšnji-Pd-msa,-*-,tolikšnji-Pd-nsg
tolikšnjem	tolikšnji-Pd-msl,-*-,tolikšnji-Pd-nsl
tolikšnjemu	tolikšnji-Pd-msd,-*-,tolikšnji-Pd-nsd
tolikšnji	tolikšnji-Pd-msn,-*-,tolikšnji-Pd-msa,-*-,tolikšnji-Pd-mpn,-*-,tolikšnji-Pd-ndn,-*-,tolikšnji-Pd-nda,-*-,tolikšnji-Pd-fdn,-*-,tolikšnji-Pd-fda,-*-,tolikšnji-Pd-fsd,-*-,tolikšnji-Pd-fsl
tolikšnjih	tolikšnji-Pd-mdl,-*-,tolikšnji-Pd-mdg,-*-,tolikšnji-Pd-mpl,-*-,tolikšnji-Pd-mpg,-*-,tolikšnji-Pd-ndl,-*-,tolikšnji-Pd-ndg,-*-,tolikšnji-Pd-npl,-*-,tolikšnji-Pd-npg,-*-,tolikšnji-Pd-fdl,-*-,tolikšnji-Pd-fdg,-*-,tolikšnji-Pd-fpl,-*-,tolikšnji-Pd-fpg
tolikšnjim	tolikšnji-Pd-msi,-*-,tolikšnji-Pd-mpd,-*-,tolikšnji-Pd-nsi,-*-,tolikšnji-Pd-npd,-*-,tolikšnji-Pd-fpd
tolikšnjima	tolikšnji-Pd-mdd,-*-,tolikšnji-Pd-mdi,-*-,tolikšnji-Pd-ndd,-*-,tolikšnji-Pd-ndi,-*-,tolikšnji-Pd-fdd,-*-,tolikšnji-Pd-fdi
tolikšnjimi	tolikšnji-Pd-mpi,-*-,tolikšnji-Pd-npi,-*-,tolikšnji-Pd-fpi
tolikšnjo	tolikšnji-Pd-fsi,-*-,tolikšnji-Pd-fsa
tolikšno	tolikšen-Pd-nsn,-*-,tolikšen-Pd-nsa,-*-,tolikšen-Pd-fsi,-*-,tolikšen-Pd-fsa
tota	toti-Pd-mdn,-*-,toti-Pd-mda,-*-,toti-Pd-npn,-*-,toti-Pd-npa,-*-,toti-Pd-fsn
tote	toti-Pd-mpa,-*-,toti-Pd-fsg,-*-,toti-Pd-fpn,-*-,toti-Pd-fpa
totega	toti-Pd-msg,-*-,toti-Pd-msa,-*-,toti-Pd-nsg
totem	toti-Pd-msl,-*-,toti-Pd-nsl
totemu	toti-Pd-msd,-*-,toti-Pd-nsd
toti	toti-Pd-msn,-*-,toti-Pd-msa,-*-,toti-Pd-mpn,-*-,toti-Pd-ndn,-*-,toti-Pd-nda,-*-,toti-Pd-fdn,-*-,toti-Pd-fda,-*-,toti-Pd-fsd,-*-,toti-Pd-fsl
totih	toti-Pd-mdl,-*-,toti-Pd-mdg,-*-,toti-Pd-mpl,-*-,toti-Pd-mpg,-*-,toti-Pd-ndl,-*-,toti-Pd-ndg,-*-,toti-Pd-npl,-*-,toti-Pd-npg,-*-,toti-Pd-fdl,-*-,toti-Pd-fdg,-*-,toti-Pd-fpl,-*-,toti-Pd-fpg
totim	toti-Pd-msi,-*-,toti-Pd-mpd,-*-,toti-Pd-nsi,-*-,toti-Pd-npd,-*-,toti-Pd-fpd
totima	toti-Pd-mdd,-*-,toti-Pd-mdi,-*-,toti-Pd-ndd,-*-,toti-Pd-ndi,-*-,toti-Pd-fdd,-*-,toti-Pd-fdi
totimi	toti-Pd-mpi,-*-,toti-Pd-npi,-*-,toti-Pd-fpi
toto	toti-Pd-nsn,-*-,toti-Pd-nsa,-*-,toti-Pd-fsi,-*-,toti-Pd-fsa
tvoj	tvoj-Ps2msns,-*-,tvoj-Ps2msas
tvoja	tvoj-Ps2mdns,-*-,tvoj-Ps2mdas,-*-,tvoj-Ps2npns,-*-,tvoj-Ps2npas,-*-,tvoj-Ps2fsns
tvoje	tvoj-Ps2mpas,-*-,tvoj-Ps2nsns,-*-,tvoj-Ps2nsas,-*-,tvoj-Ps2fsgs,-*-,tvoj-Ps2fpns,-*-,tvoj-Ps2fpas
tvojega	tvoj-Ps2msgs,-*-,tvoj-Ps2msas,-*-,tvoj-Ps2nsgs
tvojem	tvoj-Ps2msls,-*-,tvoj-Ps2nsls
tvojemu	tvoj-Ps2msds,-*-,tvoj-Ps2nsds
tvoji	tvoj-Ps2mpns,-*-,tvoj-Ps2ndns,-*-,tvoj-Ps2ndas,-*-,tvoj-Ps2fdns,-*-,tvoj-Ps2fdas,-*-,tvoj-Ps2fsds,-*-,tvoj-Ps2fsls
tvojih	tvoj-Ps2mdls,-*-,tvoj-Ps2mdgs,-*-,tvoj-Ps2mpls,-*-,tvoj-Ps2mpgs,-*-,tvoj-Ps2ndls,-*-,tvoj-Ps2ndgs,-*-,tvoj-Ps2npls,-*-,tvoj-Ps2npgs,-*-,tvoj-Ps2fdls,-*-,tvoj-Ps2fdgs,-*-,tvoj-Ps2fpls,-*-,tvoj-Ps2fpgs
tvojim	tvoj-Ps2msis,-*-,tvoj-Ps2mpds,-*-,tvoj-Ps2nsis,-*-,tvoj-Ps2npds,-*-,tvoj-Ps2fpds
tvojima	tvoj-Ps2mdds,-*-,tvoj-Ps2mdis,-*-,tvoj-Ps2ndds,-*-,tvoj-Ps2ndis,-*-,tvoj-Ps2fdds,-*-,tvoj-Ps2fdis
tvojimi	tvoj-Ps2mpis,-*-,tvoj-Ps2npis,-*-,tvoj-Ps2fpis
tvojo	tvoj-Ps2fsis,-*-,tvoj-Ps2fsas
vajin	vajin-Ps2msnd,-*-,vajin-Ps2msad
vajina	vajin-Ps2mdnd,-*-,vajin-Ps2mdad,-*-,vajin-Ps2npnd,-*-,vajin-Ps2npad,-*-,vajin-Ps2fsnd
vajine	vajin-Ps2mpad,-*-,vajin-Ps2fsgd,-*-,vajin-Ps2fpnd,-*-,vajin-Ps2fpad
vajinega	vajin-Ps2msgd,-*-,vajin-Ps2msad,-*-,vajin-Ps2nsgd
vajinem	vajin-Ps2msld,-*-,vajin-Ps2nsld
vajinemu	vajin-Ps2msdd,-*-,vajin-Ps2nsdd
vajini	vajin-Ps2mpnd,-*-,vajin-Ps2ndnd,-*-,vajin-Ps2ndad,-*-,vajin-Ps2fdnd,-*-,vajin-Ps2fdad,-*-,vajin-Ps2fsdd,-*-,vajin-Ps2fsld
vajinih	vajin-Ps2mdld,-*-,vajin-Ps2mdgd,-*-,vajin-Ps2mpld,-*-,vajin-Ps2mpgd,-*-,vajin-Ps2ndld,-*-,vajin-Ps2ndgd,-*-,vajin-Ps2npld,-*-,vajin-Ps2npgd,-*-,vajin-Ps2fdld,-*-,vajin-Ps2fdgd,-*-,vajin-Ps2fpld,-*-,vajin-Ps2fpgd
vajinim	vajin-Ps2msid,-*-,vajin-Ps2mpdd,-*-,vajin-Ps2nsid,-*-,vajin-Ps2npdd,-*-,vajin-Ps2fpdd
vajinima	vajin-Ps2mddd,-*-,vajin-Ps2mdid,-*-,vajin-Ps2nddd,-*-,vajin-Ps2ndid,-*-,vajin-Ps2fddd,-*-,vajin-Ps2fdid
vajinimi	vajin-Ps2mpid,-*-,vajin-Ps2npid,-*-,vajin-Ps2fpid
vajino	vajin-Ps2nsnd,-*-,vajin-Ps2nsad,-*-,vajin-Ps2fsid,-*-,vajin-Ps2fsad
vaju	ti-Pp2-dl,-*-,ti-Pp2-dg,-*-,ti-Pp2-da
vam	ti-Pp2-pd
vama	ti-Pp2-dd,-*-,ti-Pp2-dl,-*-,ti-Pp2-di
vame	vame-Pp1-sa--b
vami	ti-Pp2-pi
vanj	vame-Pp3msa--b,-*-,vame-Pp3nsa--b
vanje	vame-Pp3mpa--b,-*-,vame-Pp3npa--b,-*-,vame-Pp3fpa--b
vanjo	vame-Pp3fsa--b
vanju	vame-Pp3mda--b,-*-,vame-Pp3nda--b,-*-,vame-Pp3fda--b
vas	ti-Pp2-pl,-*-,ti-Pp2-pg,-*-,ti-Pp2-pa
vase	vase-Px---a--b
vate	vame-Pp2-sa--b
vaš	vaš-Ps2msnp,-*-,vaš-Ps2msap
vaša	vaš-Ps2mdnp,-*-,vaš-Ps2mdap,-*-,vaš-Ps2npnp,-*-,vaš-Ps2npap,-*-,vaš-Ps2fsnp
vaše	vaš-Ps2mpap,-*-,vaš-Ps2nsnp,-*-,vaš-Ps2nsap,-*-,vaš-Ps2fsgp,-*-,vaš-Ps2fpnp,-*-,vaš-Ps2fpap
vašega	vaš-Ps2msgp,-*-,vaš-Ps2msap,-*-,vaš-Ps2nsgp
vašem	vaš-Ps2mslp,-*-,vaš-Ps2nslp
vašemu	vaš-Ps2msdp,-*-,vaš-Ps2nsdp
vaši	vaš-Ps2mpnp,-*-,vaš-Ps2ndnp,-*-,vaš-Ps2ndap,-*-,vaš-Ps2fdnp,-*-,vaš-Ps2fdap,-*-,vaš-Ps2fsdp,-*-,vaš-Ps2fslp
vaših	vaš-Ps2mdlp,-*-,vaš-Ps2mdgp,-*-,vaš-Ps2mplp,-*-,vaš-Ps2mpgp,-*-,vaš-Ps2ndlp,-*-,vaš-Ps2ndgp,-*-,vaš-Ps2nplp,-*-,vaš-Ps2npgp,-*-,vaš-Ps2fdlp,-*-,vaš-Ps2fdgp,-*-,vaš-Ps2fplp,-*-,vaš-Ps2fpgp
vašim	vaš-Ps2msip,-*-,vaš-Ps2mpdp,-*-,vaš-Ps2nsip,-*-,vaš-Ps2npdp,-*-,vaš-Ps2fpdp
vašima	vaš-Ps2mddp,-*-,vaš-Ps2mdip,-*-,vaš-Ps2nddp,-*-,vaš-Ps2ndip,-*-,vaš-Ps2fddp,-*-,vaš-Ps2fdip
vašimi	vaš-Ps2mpip,-*-,vaš-Ps2npip,-*-,vaš-Ps2fpip
vašo	vaš-Ps2fsip,-*-,vaš-Ps2fsap
ve	ti-Pp2fpn
vedve	ti-Pp2fdn
ves	ves-Pg-msn,-*-,ves-Pg-msa
vi	ti-Pp2mpn,-*-,ti-Pp2npn
vidva	ti-Pp2mdn,-*-,ti-Pp2ndn
vidve	ti-Pp2fdn
vsa	ves-Pg-mdn,-*-,ves-Pg-mda,-*-,ves-Pg-npn,-*-,ves-Pg-npa,-*-,ves-Pg-fsn
vsak	vsak-Pg-msn,-*-,vsak-Pg-msa
vsaka	vsak-Pg-mdn,-*-,vsak-Pg-mda,-*-,vsak-Pg-npn,-*-,vsak-Pg-npa,-*-,vsak-Pg-fsn
vsakatera	vsakateri-Pg-mdn,-*-,vsakateri-Pg-mda,-*-,vsakateri-Pg-npn,-*-,vsakateri-Pg-npa,-*-,vsakateri-Pg-fsn
vsakatere	vsakateri-Pg-mpa,-*-,vsakateri-Pg-fsg,-*-,vsakateri-Pg-fpn,-*-,vsakateri-Pg-fpa
vsakaterega	vsakateri-Pg-msg,-*-,vsakateri-Pg-msa,-*-,vsakateri-Pg-nsg
vsakaterem	vsakateri-Pg-msl,-*-,vsakateri-Pg-nsl
vsakateremu	vsakateri-Pg-msd,-*-,vsakateri-Pg-nsd
vsakateri	vsakateri-Pg-msn,-*-,vsakateri-Pg-msa,-*-,vsakateri-Pg-mpn,-*-,vsakateri-Pg-ndn,-*-,vsakateri-Pg-nda,-*-,vsakateri-Pg-fdn,-*-,vsakateri-Pg-fda,-*-,vsakateri-Pg-fsd,-*-,vsakateri-Pg-fsl
vsakaterih	vsakateri-Pg-mdl,-*-,vsakateri-Pg-mdg,-*-,vsakateri-Pg-mpl,-*-,vsakateri-Pg-mpg,-*-,vsakateri-Pg-ndl,-*-,vsakateri-Pg-ndg,-*-,vsakateri-Pg-npl,-*-,vsakateri-Pg-npg,-*-,vsakateri-Pg-fdl,-*-,vsakateri-Pg-fdg,-*-,vsakateri-Pg-fpl,-*-,vsakateri-Pg-fpg
vsakaterim	vsakateri-Pg-msi,-*-,vsakateri-Pg-mpd,-*-,vsakateri-Pg-nsi,-*-,vsakateri-Pg-npd,-*-,vsakateri-Pg-fpd
vsakaterima	vsakateri-Pg-mdd,-*-,vsakateri-Pg-mdi,-*-,vsakateri-Pg-ndd,-*-,vsakateri-Pg-ndi,-*-,vsakateri-Pg-fdd,-*-,vsakateri-Pg-fdi
vsakaterimi	vsakateri-Pg-mpi,-*-,vsakateri-Pg-npi,-*-,vsakateri-Pg-fpi
vsakatero	vsakateri-Pg-nsn,-*-,vsakateri-Pg-nsa,-*-,vsakateri-Pg-fsi,-*-,vsakateri-Pg-fsa
vsakdo	vsakdo-Pg-msn
vsake	vsak-Pg-mpa,-*-,vsak-Pg-fsg,-*-,vsak-Pg-fpn,-*-,vsak-Pg-fpa
vsakega	vsak-Pg-msg,-*-,vsak-Pg-msa,-*-,vsak-Pg-nsg
vsakem	vsak-Pg-msl,-*-,vsak-Pg-nsl
vsakemu	vsak-Pg-msd,-*-,vsak-Pg-nsd
vsaki	vsak-Pg-mpn,-*-,vsak-Pg-ndn,-*-,vsak-Pg-nda,-*-,vsak-Pg-fdn,-*-,vsak-Pg-fda,-*-,vsak-Pg-fsd,-*-,vsak-Pg-fsl
vsakih	vsak-Pg-mdl,-*-,vsak-Pg-mdg,-*-,vsak-Pg-mpl,-*-,vsak-Pg-mpg,-*-,vsak-Pg-ndl,-*-,vsak-Pg-ndg,-*-,vsak-Pg-npl,-*-,vsak-Pg-npg,-*-,vsak-Pg-fdl,-*-,vsak-Pg-fdg,-*-,vsak-Pg-fpl,-*-,vsak-Pg-fpg
vsakim	vsak-Pg-msi,-*-,vsak-Pg-mpd,-*-,vsak-Pg-nsi,-*-,vsak-Pg-npd,-*-,vsak-Pg-fpd
vsakima	vsak-Pg-mdd,-*-,vsak-Pg-mdi,-*-,vsak-Pg-ndd,-*-,vsak-Pg-ndi,-*-,vsak-Pg-fdd,-*-,vsak-Pg-fdi
vsakimi	vsak-Pg-mpi,-*-,vsak-Pg-npi,-*-,vsak-Pg-fpi
vsako	vsak-Pg-nsn,-*-,vsak-Pg-nsa,-*-,vsak-Pg-fsi,-*-,vsak-Pg-fsa
vsakogar	vsakdo-Pg-msg,-*-,vsakdo-Pg-msa
vsakogaršen	vsakogaršen-Pg-msn,-*-,vsakogaršen-Pg-msa
vsakogaršna	vsakogaršen-Pg-mdn,-*-,vsakogaršen-Pg-mda,-*-,vsakogaršen-Pg-npn,-*-,vsakogaršen-Pg-npa,-*-,vsakogaršen-Pg-fsn
vsakogaršne	vsakogaršen-Pg-mpa,-*-,vsakogaršen-Pg-fsg,-*-,vsakogaršen-Pg-fpn,-*-,vsakogaršen-Pg-fpa
vsakogaršnega	vsakogaršen-Pg-msg,-*-,vsakogaršen-Pg-msa,-*-,vsakogaršen-Pg-nsg
vsakogaršnem	vsakogaršen-Pg-msl,-*-,vsakogaršen-Pg-nsl
vsakogaršnemu	vsakogaršen-Pg-msd,-*-,vsakogaršen-Pg-nsd
vsakogaršni	vsakogaršen-Pg-mpn,-*-,vsakogaršen-Pg-ndn,-*-,vsakogaršen-Pg-nda,-*-,vsakogaršen-Pg-fdn,-*-,vsakogaršen-Pg-fda,-*-,vsakogaršen-Pg-fsd,-*-,vsakogaršen-Pg-fsl
vsakogaršnih	vsakogaršen-Pg-mdl,-*-,vsakogaršen-Pg-mdg,-*-,vsakogaršen-Pg-mpl,-*-,vsakogaršen-Pg-mpg,-*-,vsakogaršen-Pg-ndl,-*-,vsakogaršen-Pg-ndg,-*-,vsakogaršen-Pg-npl,-*-,vsakogaršen-Pg-npg,-*-,vsakogaršen-Pg-fdl,-*-,vsakogaršen-Pg-fdg,-*-,vsakogaršen-Pg-fpl,-*-,vsakogaršen-Pg-fpg
vsakogaršnim	vsakogaršen-Pg-msi,-*-,vsakogaršen-Pg-mpd,-*-,vsakogaršen-Pg-nsi,-*-,vsakogaršen-Pg-npd,-*-,vsakogaršen-Pg-fpd
vsakogaršnima	vsakogaršen-Pg-mdd,-*-,vsakogaršen-Pg-mdi,-*-,vsakogaršen-Pg-ndd,-*-,vsakogaršen-Pg-ndi,-*-,vsakogaršen-Pg-fdd,-*-,vsakogaršen-Pg-fdi
vsakogaršnimi	vsakogaršen-Pg-mpi,-*-,vsakogaršen-Pg-npi,-*-,vsakogaršen-Pg-fpi
vsakogaršnja	vsakogaršnji-Pg-mdn,-*-,vsakogaršnji-Pg-mda,-*-,vsakogaršnji-Pg-npn,-*-,vsakogaršnji-Pg-npa,-*-,vsakogaršnji-Pg-fsn
vsakogaršnje	vsakogaršnji-Pg-mpa,-*-,vsakogaršnji-Pg-nsn,-*-,vsakogaršnji-Pg-nsa,-*-,vsakogaršnji-Pg-fsg,-*-,vsakogaršnji-Pg-fpn,-*-,vsakogaršnji-Pg-fpa
vsakogaršnjega	vsakogaršnji-Pg-msg,-*-,vsakogaršnji-Pg-msa,-*-,vsakogaršnji-Pg-nsg
vsakogaršnjem	vsakogaršnji-Pg-msl,-*-,vsakogaršnji-Pg-nsl
vsakogaršnjemu	vsakogaršnji-Pg-msd,-*-,vsakogaršnji-Pg-nsd
vsakogaršnji	vsakogaršnji-Pg-msn,-*-,vsakogaršnji-Pg-msa,-*-,vsakogaršnji-Pg-mpn,-*-,vsakogaršnji-Pg-ndn,-*-,vsakogaršnji-Pg-nda,-*-,vsakogaršnji-Pg-fdn,-*-,vsakogaršnji-Pg-fda,-*-,vsakogaršnji-Pg-fsd,-*-,vsakogaršnji-Pg-fsl
vsakogaršnjih	vsakogaršnji-Pg-mdl,-*-,vsakogaršnji-Pg-mdg,-*-,vsakogaršnji-Pg-mpl,-*-,vsakogaršnji-Pg-mpg,-*-,vsakogaršnji-Pg-ndl,-*-,vsakogaršnji-Pg-ndg,-*-,vsakogaršnji-Pg-npl,-*-,vsakogaršnji-Pg-npg,-*-,vsakogaršnji-Pg-fdl,-*-,vsakogaršnji-Pg-fdg,-*-,vsakogaršnji-Pg-fpl,-*-,vsakogaršnji-Pg-fpg
vsakogaršnjim	vsakogaršnji-Pg-msi,-*-,vsakogaršnji-Pg-mpd,-*-,vsakogaršnji-Pg-nsi,-*-,vsakogaršnji-Pg-npd,-*-,vsakogaršnji-Pg-fpd
vsakogaršnjima	vsakogaršnji-Pg-mdd,-*-,vsakogaršnji-Pg-mdi,-*-,vsakogaršnji-Pg-ndd,-*-,vsakogaršnji-Pg-ndi,-*-,vsakogaršnji-Pg-fdd,-*-,vsakogaršnji-Pg-fdi
vsakogaršnjimi	vsakogaršnji-Pg-mpi,-*-,vsakogaršnji-Pg-npi,-*-,vsakogaršnji-Pg-fpi
vsakogaršnjo	vsakogaršnji-Pg-fsi,-*-,vsakogaršnji-Pg-fsa
vsakogaršno	vsakogaršen-Pg-nsn,-*-,vsakogaršen-Pg-nsa,-*-,vsakogaršen-Pg-fsi,-*-,vsakogaršen-Pg-fsa
vsakomer	vsakdo-Pg-msl,-*-,vsakdo-Pg-msi
vsakomur	vsakdo-Pg-msd
vsakršen	vsakršen-Pg-msn,-*-,vsakršen-Pg-msa
vsakršna	vsakršen-Pg-mdn,-*-,vsakršen-Pg-mda,-*-,vsakršen-Pg-npn,-*-,vsakršen-Pg-npa,-*-,vsakršen-Pg-fsn
vsakršne	vsakršen-Pg-mpa,-*-,vsakršen-Pg-fsg,-*-,vsakršen-Pg-fpn,-*-,vsakršen-Pg-fpa
vsakršnega	vsakršen-Pg-msg,-*-,vsakršen-Pg-msa,-*-,vsakršen-Pg-nsg
vsakršnem	vsakršen-Pg-msl,-*-,vsakršen-Pg-nsl
vsakršnemu	vsakršen-Pg-msd,-*-,vsakršen-Pg-nsd
vsakršni	vsakršen-Pg-mpn,-*-,vsakršen-Pg-ndn,-*-,vsakršen-Pg-nda,-*-,vsakršen-Pg-fdn,-*-,vsakršen-Pg-fda,-*-,vsakršen-Pg-fsd,-*-,vsakršen-Pg-fsl
vsakršnih	vsakršen-Pg-mdl,-*-,vsakršen-Pg-mdg,-*-,vsakršen-Pg-mpl,-*-,vsakršen-Pg-mpg,-*-,vsakršen-Pg-ndl,-*-,vsakršen-Pg-ndg,-*-,vsakršen-Pg-npl,-*-,vsakršen-Pg-npg,-*-,vsakršen-Pg-fdl,-*-,vsakršen-Pg-fdg,-*-,vsakršen-Pg-fpl,-*-,vsakršen-Pg-fpg
vsakršnim	vsakršen-Pg-msi,-*-,vsakršen-Pg-mpd,-*-,vsakršen-Pg-nsi,-*-,vsakršen-Pg-npd,-*-,vsakršen-Pg-fpd
vsakršnima	vsakršen-Pg-mdd,-*-,vsakršen-Pg-mdi,-*-,vsakršen-Pg-ndd,-*-,vsakršen-Pg-ndi,-*-,vsakršen-Pg-fdd,-*-,vsakršen-Pg-fdi
vsakršnimi	vsakršen-Pg-mpi,-*-,vsakršen-Pg-npi,-*-,vsakršen-Pg-fpi
vsakršno	vsakršen-Pg-nsn,-*-,vsakršen-Pg-nsa,-*-,vsakršen-Pg-fsi,-*-,vsakršen-Pg-fsa
vsaktera	vsakteri-Pg-mdn,-*-,vsakteri-Pg-mda,-*-,vsakteri-Pg-npn,-*-,vsakteri-Pg-npa,-*-,vsakteri-Pg-fsn
vsaktere	vsakteri-Pg-mpa,-*-,vsakteri-Pg-fsg,-*-,vsakteri-Pg-fpn,-*-,vsakteri-Pg-fpa
vsakterega	vsakteri-Pg-msg,-*-,vsakteri-Pg-msa,-*-,vsakteri-Pg-nsg
vsakterem	vsakteri-Pg-msl,-*-,vsakteri-Pg-nsl
vsakteremu	vsakteri-Pg-msd,-*-,vsakteri-Pg-nsd
vsakteri	vsakteri-Pg-msn,-*-,vsakteri-Pg-msa,-*-,vsakteri-Pg-mpn,-*-,vsakteri-Pg-ndn,-*-,vsakteri-Pg-nda,-*-,vsakteri-Pg-fdn,-*-,vsakteri-Pg-fda,-*-,vsakteri-Pg-fsd,-*-,vsakteri-Pg-fsl
vsakterih	vsakteri-Pg-mdl,-*-,vsakteri-Pg-mdg,-*-,vsakteri-Pg-mpl,-*-,vsakteri-Pg-mpg,-*-,vsakteri-Pg-ndl,-*-,vsakteri-Pg-ndg,-*-,vsakteri-Pg-npl,-*-,vsakteri-Pg-npg,-*-,vsakteri-Pg-fdl,-*-,vsakteri-Pg-fdg,-*-,vsakteri-Pg-fpl,-*-,vsakteri-Pg-fpg
vsakterim	vsakteri-Pg-msi,-*-,vsakteri-Pg-mpd,-*-,vsakteri-Pg-nsi,-*-,vsakteri-Pg-npd,-*-,vsakteri-Pg-fpd
vsakterima	vsakteri-Pg-mdd,-*-,vsakteri-Pg-mdi,-*-,vsakteri-Pg-ndd,-*-,vsakteri-Pg-ndi,-*-,vsakteri-Pg-fdd,-*-,vsakteri-Pg-fdi
vsakterimi	vsakteri-Pg-mpi,-*-,vsakteri-Pg-npi,-*-,vsakteri-Pg-fpi
vsaktero	vsakteri-Pg-nsn,-*-,vsakteri-Pg-nsa,-*-,vsakteri-Pg-fsi,-*-,vsakteri-Pg-fsa
vse	ves-Pg-mpa,-*-,ves-Pg-nsn,-*-,ves-Pg-nsa,-*-,ves-Pg-fsg,-*-,ves-Pg-fpn,-*-,ves-Pg-fpa
vsega	ves-Pg-msg,-*-,ves-Pg-msa,-*-,ves-Pg-nsg
vseh	ves-Pg-mdl,-*-,ves-Pg-mdg,-*-,ves-Pg-mpl,-*-,ves-Pg-mpg,-*-,ves-Pg-ndl,-*-,ves-Pg-ndg,-*-,ves-Pg-npl,-*-,ves-Pg-npg,-*-,ves-Pg-fdl,-*-,ves-Pg-fdg,-*-,ves-Pg-fpl,-*-,ves-Pg-fpg
vsej	ves-Pg-fsd,-*-,ves-Pg-fsl
vsem	ves-Pg-msl,-*-,ves-Pg-msi,-*-,ves-Pg-mpd,-*-,ves-Pg-nsl,-*-,ves-Pg-nsi,-*-,ves-Pg-npd,-*-,ves-Pg-fpd
vsema	ves-Pg-mdd,-*-,ves-Pg-mdi,-*-,ves-Pg-ndd,-*-,ves-Pg-ndi,-*-,ves-Pg-fdd,-*-,ves-Pg-fdi
vsemi	ves-Pg-mpi,-*-,ves-Pg-npi,-*-,ves-Pg-fpi
vsemu	ves-Pg-msd,-*-,ves-Pg-nsd
vsi	ves-Pg-mpn,-*-,ves-Pg-ndn,-*-,ves-Pg-nda,-*-,ves-Pg-fdn,-*-,ves-Pg-fda
vso	ves-Pg-fsi,-*-,ves-Pg-fsa
zame	zame-Pp1-sa--b
zanj	zame-Pp3msa--b,-*-,zame-Pp3nsa--b
zanje	zame-Pp3mpa--b,-*-,zame-Pp3npa--b,-*-,zame-Pp3fpa--b
zanjo	zame-Pp3fsa--b
zanju	zame-Pp3mda--b,-*-,zame-Pp3nda--b,-*-,zame-Pp3fda--b
zase	zase-Px---a--b
zate	zame-Pp2-sa--b
čem	kaj-Pq-nsl
čemer	kar-Pr-nsl
čemerkoli	karkoli-Pr-nsl
čemersibodi	karsibodi-Pr-nsl
čemersižebodi	karsižebodi-Pr-nsl
čemu	kaj-Pq-nsd
čemur	kar-Pr-nsd
čemurkoli	karkoli-Pr-nsd
čemursibodi	karsibodi-Pr-nsd
čemursižebodi	karsižebodi-Pr-nsd
česa	kaj-Pq-nsg
česar	kar-Pr-nsg
česarkoli	karkoli-Pr-nsg
česarsibodi	karsibodi-Pr-nsg
česarsižebodi	karsižebodi-Pr-nsg
čezenj	čezme-Pp3msa--b,-*-,čezme-Pp3nsa--b
čezme	čezme-Pp1-sa--b
čeznje	čezme-Pp3mpa--b,-*-,čezme-Pp3npa--b,-*-,čezme-Pp3fpa--b
čeznjo	čezme-Pp3fsa--b
čeznju	čezme-Pp3mda--b,-*-,čezme-Pp3nda--b,-*-,čezme-Pp3fda--b
čezse	čezse-Px---a--b
čezte	čezme-Pp2-sa--b
čigar	čigar-Pr----sm
čigarkoli	čigarkoli-Pr
čigarsižebodi	čigarsižebodi-Pr
čigav	čigav-Pq-msn,-*-,čigav-Pq-msa
čigava	čigav-Pq-mdn,-*-,čigav-Pq-mda,-*-,čigav-Pq-npn,-*-,čigav-Pq-npa,-*-,čigav-Pq-fsn
čigave	čigav-Pq-mpa,-*-,čigav-Pq-fsg,-*-,čigav-Pq-fpn,-*-,čigav-Pq-fpa
čigavega	čigav-Pq-msg,-*-,čigav-Pq-msa,-*-,čigav-Pq-nsg
čigavem	čigav-Pq-msl,-*-,čigav-Pq-nsl
čigavemu	čigav-Pq-msd,-*-,čigav-Pq-nsd
čigaver	čigaver-Pr
čigaverkoli	čigaverkoli-Pr
čigavi	čigav-Pq-mpn,-*-,čigav-Pq-ndn,-*-,čigav-Pq-nda,-*-,čigav-Pq-fdn,-*-,čigav-Pq-fda,-*-,čigav-Pq-fsd,-*-,čigav-Pq-fsl
čigavih	čigav-Pq-mdl,-*-,čigav-Pq-mdg,-*-,čigav-Pq-mpl,-*-,čigav-Pq-mpg,-*-,čigav-Pq-ndl,-*-,čigav-Pq-ndg,-*-,čigav-Pq-npl,-*-,čigav-Pq-npg,-*-,čigav-Pq-fdl,-*-,čigav-Pq-fdg,-*-,čigav-Pq-fpl,-*-,čigav-Pq-fpg
čigavim	čigav-Pq-msi,-*-,čigav-Pq-mpd,-*-,čigav-Pq-nsi,-*-,čigav-Pq-npd,-*-,čigav-Pq-fpd
čigavima	čigav-Pq-mdd,-*-,čigav-Pq-mdi,-*-,čigav-Pq-ndd,-*-,čigav-Pq-ndi,-*-,čigav-Pq-fdd,-*-,čigav-Pq-fdi
čigavimi	čigav-Pq-mpi,-*-,čigav-Pq-npi,-*-,čigav-Pq-fpi
čigavo	čigav-Pq-nsn,-*-,čigav-Pq-nsa,-*-,čigav-Pq-fsi,-*-,čigav-Pq-fsa
čigavršen	čigavršen-Pr-msn,-*-,čigavršen-Pr-msa
čigavršna	čigavršen-Pr-mdn,-*-,čigavršen-Pr-mda,-*-,čigavršen-Pr-npn,-*-,čigavršen-Pr-npa,-*-,čigavršen-Pr-fsn
čigavršne	čigavršen-Pr-mpa,-*-,čigavršen-Pr-fsg,-*-,čigavršen-Pr-fpn,-*-,čigavršen-Pr-fpa
čigavršnega	čigavršen-Pr-msg,-*-,čigavršen-Pr-msa,-*-,čigavršen-Pr-nsg
čigavršnem	čigavršen-Pr-msl,-*-,čigavršen-Pr-nsl
čigavršnemu	čigavršen-Pr-msd,-*-,čigavršen-Pr-nsd
čigavršni	čigavršen-Pr-mpn,-*-,čigavršen-Pr-ndn,-*-,čigavršen-Pr-nda,-*-,čigavršen-Pr-fdn,-*-,čigavršen-Pr-fda,-*-,čigavršen-Pr-fsd,-*-,čigavršen-Pr-fsl
čigavršnih	čigavršen-Pr-mdl,-*-,čigavršen-Pr-mdg,-*-,čigavršen-Pr-mpl,-*-,čigavršen-Pr-mpg,-*-,čigavršen-Pr-ndl,-*-,čigavršen-Pr-ndg,-*-,čigavršen-Pr-npl,-*-,čigavršen-Pr-npg,-*-,čigavršen-Pr-fdl,-*-,čigavršen-Pr-fdg,-*-,čigavršen-Pr-fpl,-*-,čigavršen-Pr-fpg
čigavršnim	čigavršen-Pr-msi,-*-,čigavršen-Pr-mpd,-*-,čigavršen-Pr-nsi,-*-,čigavršen-Pr-npd,-*-,čigavršen-Pr-fpd
čigavršnima	čigavršen-Pr-mdd,-*-,čigavršen-Pr-mdi,-*-,čigavršen-Pr-ndd,-*-,čigavršen-Pr-ndi,-*-,čigavršen-Pr-fdd,-*-,čigavršen-Pr-fdi
čigavršnimi	čigavršen-Pr-mpi,-*-,čigavršen-Pr-npi,-*-,čigavršen-Pr-fpi
čigavršnja	čigavršnji-Pr-mdn,-*-,čigavršnji-Pr-mda,-*-,čigavršnji-Pr-npn,-*-,čigavršnji-Pr-npa,-*-,čigavršnji-Pr-fsn
čigavršnje	čigavršnji-Pr-mpa,-*-,čigavršnji-Pr-nsn,-*-,čigavršnji-Pr-nsa,-*-,čigavršnji-Pr-fsg,-*-,čigavršnji-Pr-fpn,-*-,čigavršnji-Pr-fpa
čigavršnjega	čigavršnji-Pr-msg,-*-,čigavršnji-Pr-msa,-*-,čigavršnji-Pr-nsg
čigavršnjem	čigavršnji-Pr-msl,-*-,čigavršnji-Pr-nsl
čigavršnjemu	čigavršnji-Pr-msd,-*-,čigavršnji-Pr-nsd
čigavršnji	čigavršnji-Pr-msn,-*-,čigavršnji-Pr-msa,-*-,čigavršnji-Pr-mpn,-*-,čigavršnji-Pr-ndn,-*-,čigavršnji-Pr-nda,-*-,čigavršnji-Pr-fdn,-*-,čigavršnji-Pr-fda,-*-,čigavršnji-Pr-fsd,-*-,čigavršnji-Pr-fsl
čigavršnjih	čigavršnji-Pr-mdl,-*-,čigavršnji-Pr-mdg,-*-,čigavršnji-Pr-mpl,-*-,čigavršnji-Pr-mpg,-*-,čigavršnji-Pr-ndl,-*-,čigavršnji-Pr-ndg,-*-,čigavršnji-Pr-npl,-*-,čigavršnji-Pr-npg,-*-,čigavršnji-Pr-fdl,-*-,čigavršnji-Pr-fdg,-*-,čigavršnji-Pr-fpl,-*-,čigavršnji-Pr-fpg
čigavršnjim	čigavršnji-Pr-msi,-*-,čigavršnji-Pr-mpd,-*-,čigavršnji-Pr-nsi,-*-,čigavršnji-Pr-npd,-*-,čigavršnji-Pr-fpd
čigavršnjima	čigavršnji-Pr-mdd,-*-,čigavršnji-Pr-mdi,-*-,čigavršnji-Pr-ndd,-*-,čigavršnji-Pr-ndi,-*-,čigavršnji-Pr-fdd,-*-,čigavršnji-Pr-fdi
čigavršnjimi	čigavršnji-Pr-mpi,-*-,čigavršnji-Pr-npi,-*-,čigavršnji-Pr-fpi
čigavršnjo	čigavršnji-Pr-fsi,-*-,čigavršnji-Pr-fsa
čigavršno	čigavršen-Pr-nsn,-*-,čigavršen-Pr-nsa,-*-,čigavršen-Pr-fsi,-*-,čigavršen-Pr-fsa
čim	kaj-Pq-nsi
čimer	kar-Pr-nsi
čimerkoli	karkoli-Pr-nsi
čimersibodi	karsibodi-Pr-nsi
čimersižebodi	karsižebodi-Pr-nsi
